,id,session,species,recordStart,recordStartDate,recordEnd,recordEndDate,hops,c_short,c_long,c_total,c_diff
0,0,1,B. pascuorum,1746979960764,2025-05-11T16:12:40.764Z,1746980080764,2025-05-11T16:14:40.764Z,"[{'type': 's', 'time': '2025-05-11T16:12:48.314Z'}, {'type': 's', 'time': '2025-05-11T16:13:02.387Z'}, {'type': 's', 'time': '2025-05-11T16:13:25.882Z'}, {'type': 'l', 'time': '2025-05-11T16:13:32.865Z'}, {'type': 's', 'time': '2025-05-11T16:13:42.943Z'}, {'type': 's', 'time': '2025-05-11T16:13:47.101Z'}, {'type': 's', 'time': '2025-05-11T16:14:00.342Z'}, {'type': 's', 'time': '2025-05-11T16:14:06.808Z'}, {'type': 's', 'time': '2025-05-11T16:14:14.066Z'}, {'type': 's', 'time': '2025-05-11T16:14:16.228Z'}, {'type': 's', 'time': '2025-05-11T16:14:20.765Z'}, {'type': 'l', 'time': '2025-05-11T16:14:22.824Z'}, {'type': 's', 'time': '2025-05-11T16:14:28.205Z'}, {'type': 's', 'time': '2025-05-11T16:14:30.074Z'}, {'type': 's', 'time': '2025-05-11T16:14:35.482Z'}, {'type': 's', 'time': '2025-05-11T16:14:37.247Z'}, {'type': 's', 'time': '2025-05-11T16:14:39.356Z'}, {'type': 'l', 'time': '2025-05-11T16:14:40.848Z'}]",15,3,18,12
1,1,1,B. hortorum,1746980169978,2025-05-11T16:16:09.978Z,1746980289978,2025-05-11T16:18:09.978Z,"[{'type': 'l', 'time': '2025-05-11T16:16:14.377Z'}, {'type': 's', 'time': '2025-05-11T16:16:26.122Z'}, {'type': 's', 'time': '2025-05-11T16:16:32.164Z'}, {'type': 's', 'time': '2025-05-11T16:16:39.782Z'}, {'type': 'l', 'time': '2025-05-11T16:16:44.681Z'}, {'type': 's', 'time': '2025-05-11T16:16:55.011Z'}, {'type': 'l', 'time': '2025-05-11T16:17:03.126Z'}, {'type': 'l', 'time': '2025-05-11T16:17:08.122Z'}, {'type': 's', 'time': '2025-05-11T16:17:14.163Z'}, {'type': 's', 'time': '2025-05-11T16:17:16.802Z'}, {'type': 'l', 'time': '2025-05-11T16:17:20.029Z'}, {'type': 'l', 'time': '2025-05-11T16:17:25.919Z'}, {'type': 's', 'time': '2025-05-11T16:17:34.670Z'}, {'type': 's', 'time': '2025-05-11T16:17:40.294Z'}, {'type': 'l', 'time': '2025-05-11T16:17:47.975Z'}, {'type': 's', 'time': '2025-05-11T16:17:50.326Z'}, {'type': 's', 'time': '2025-05-11T16:17:53.520Z'}, {'type': 'l', 'time': '2025-05-11T16:17:56.703Z'}, {'type': 'l', 'time': '2025-05-11T16:18:05.517Z'}]",10,9,19,1
2,2,1,B. hypnorum,1746980413993,2025-05-11T16:20:13.993Z,1746980533993,2025-05-11T16:22:13.993Z,"[{'type': 's', 'time': '2025-05-11T16:20:16.111Z'}, {'type': 's', 'time': '2025-05-11T16:20:24.866Z'}, {'type': 's', 'time': '2025-05-11T16:20:37.790Z'}, {'type': 's', 'time': '2025-05-11T16:20:42.583Z'}, {'type': 's', 'time': '2025-05-11T16:20:54.983Z'}, {'type': 'l', 'time': '2025-05-11T16:21:31.156Z'}, {'type': 's', 'time': '2025-05-11T16:21:37.077Z'}, {'type': 's', 'time': '2025-05-11T16:21:45.564Z'}, {'type': 's', 'time': '2025-05-11T16:21:51.337Z'}, {'type': 's', 'time': '2025-05-11T16:21:53.738Z'}, {'type': 'l', 'time': '2025-05-11T16:21:58.995Z'}, {'type': 's', 'time': '2025-05-11T16:22:01.760Z'}, {'type': 'l', 'time': '2025-05-11T16:22:05.119Z'}, {'type': 's', 'time': '2025-05-11T16:22:08.854Z'}, {'type': 'l', 'time': '2025-05-11T16:22:10.587Z'}, {'type': 's', 'time': '2025-05-11T16:22:12.142Z'}]",12,4,16,8
3,3,1,B. lapidarius,1746980687486,2025-05-11T16:24:47.486Z,1746980807486,2025-05-11T16:26:47.486Z,"[{'type': 's', 'time': '2025-05-11T16:24:57.027Z'}, {'type': 's', 'time': '2025-05-11T16:25:06.834Z'}, {'type': 's', 'time': '2025-05-11T16:25:20.075Z'}, {'type': 'l', 'time': '2025-05-11T16:25:23.556Z'}, {'type': 's', 'time': '2025-05-11T16:25:28.691Z'}, {'type': 'l', 'time': '2025-05-11T16:25:33.506Z'}, {'type': 's', 'time': '2025-05-11T16:25:40.199Z'}, {'type': 's', 'time': '2025-05-11T16:25:50.870Z'}, {'type': 's', 'time': '2025-05-11T16:25:58.737Z'}, {'type': 's', 'time': '2025-05-11T16:26:07.638Z'}, {'type': 's', 'time': '2025-05-11T16:26:24.791Z'}, {'type': 's', 'time': '2025-05-11T16:26:35.316Z'}, {'type': 'l', 'time': '2025-05-11T16:26:38.774Z'}, {'type': 'l', 'time': '2025-05-11T16:26:45.797Z'}]",10,4,14,6
4,4,1,B. hortorum,1746981030643,2025-05-11T16:30:30.643Z,1746981150643,2025-05-11T16:32:30.643Z,"[{'type': 's', 'time': '2025-05-11T16:30:34.479Z'}, {'type': 's', 'time': '2025-05-11T16:30:36.585Z'}, {'type': 's', 'time': '2025-05-11T16:30:38.077Z'}, {'type': 'l', 'time': '2025-05-11T16:30:41.014Z'}, {'type': 's', 'time': '2025-05-11T16:30:43.666Z'}, {'type': 's', 'time': '2025-05-11T16:30:45.293Z'}, {'type': 's', 'time': '2025-05-11T16:30:48.533Z'}, {'type': 's', 'time': '2025-05-11T16:30:49.807Z'}, {'type': 'l', 'time': '2025-05-11T16:30:51.386Z'}, {'type': 's', 'time': '2025-05-11T16:30:53.669Z'}, {'type': 's', 'time': '2025-05-11T16:30:56.059Z'}, {'type': 's', 'time': '2025-05-11T16:30:58.801Z'}, {'type': 's', 'time': '2025-05-11T16:31:00.267Z'}, {'type': 's', 'time': '2025-05-11T16:31:01.969Z'}, {'type': 's', 'time': '2025-05-11T16:31:07.473Z'}, {'type': 'l', 'time': '2025-05-11T16:31:08.711Z'}, {'type': 's', 'time': '2025-05-11T16:31:10.375Z'}, {'type': 's', 'time': '2025-05-11T16:31:12.224Z'}, {'type': 's', 'time': '2025-05-11T16:31:14.241Z'}, {'type': 's', 'time': '2025-05-11T16:31:16.209Z'}, {'type': 'l', 'time': '2025-05-11T16:31:18.743Z'}, {'type': 'l', 'time': '2025-05-11T16:31:20.357Z'}, {'type': 's', 'time': '2025-05-11T16:31:22.740Z'}, {'type': 's', 'time': '2025-05-11T16:31:23.782Z'}, {'type': 's', 'time': '2025-05-11T16:31:26.623Z'}, {'type': 's', 'time': '2025-05-11T16:31:29.015Z'}, {'type': 'l', 'time': '2025-05-11T16:31:32.374Z'}, {'type': 's', 'time': '2025-05-11T16:31:33.451Z'}, {'type': 's', 'time': '2025-05-11T16:31:35.190Z'}, {'type': 's', 'time': '2025-05-11T16:31:37.273Z'}, {'type': 'l', 'time': '2025-05-11T16:31:40.030Z'}, {'type': 'l', 'time': '2025-05-11T16:31:42.447Z'}, {'type': 's', 'time': '2025-05-11T16:31:45.074Z'}, {'type': 's', 'time': '2025-05-11T16:31:49.700Z'}, {'type': 'l', 'time': '2025-05-11T16:31:50.819Z'}, {'type': 's', 'time': '2025-05-11T16:31:51.931Z'}, {'type': 's', 'time': '2025-05-11T16:31:54.221Z'}, {'type': 's', 'time': '2025-05-11T16:31:56.368Z'}, {'type': 's', 'time': '2025-05-11T16:31:57.530Z'}, {'type': 's', 'time': '2025-05-11T16:31:59.562Z'}, {'type': 'l', 'time': '2025-05-11T16:32:02.039Z'}, {'type': 's', 'time': '2025-05-11T16:32:06.813Z'}, {'type': 's', 'time': '2025-05-11T16:32:08.647Z'}, {'type': 's', 'time': '2025-05-11T16:32:10.683Z'}, {'type': 's', 'time': '2025-05-11T16:32:12.774Z'}, {'type': 's', 'time': '2025-05-11T16:32:15.239Z'}, {'type': 'l', 'time': '2025-05-11T16:32:18.101Z'}, {'type': 's', 'time': '2025-05-11T16:32:20.793Z'}, {'type': 'l', 'time': '2025-05-11T16:32:22.640Z'}, {'type': 'l', 'time': '2025-05-11T16:32:24.845Z'}, {'type': 's', 'time': '2025-05-11T16:32:27.186Z'}, {'type': 'l', 'time': '2025-05-11T16:32:30.752Z'}]",38,14,52,24
5,5,1,B. hypnorum,1746981231087,2025-05-11T16:33:51.087Z,1746981351087,2025-05-11T16:35:51.087Z,"[{'type': 's', 'time': '2025-05-11T16:33:54.677Z'}, {'type': 's', 'time': '2025-05-11T16:34:00.622Z'}, {'type': 's', 'time': '2025-05-11T16:34:04.871Z'}, {'type': 's', 'time': '2025-05-11T16:34:06.541Z'}, {'type': 's', 'time': '2025-05-11T16:34:17.079Z'}, {'type': 's', 'time': '2025-05-11T16:34:22.562Z'}, {'type': 's', 'time': '2025-05-11T16:34:27.287Z'}, {'type': 'l', 'time': '2025-05-11T16:34:37.856Z'}, {'type': 's', 'time': '2025-05-11T16:35:01.767Z'}, {'type': 's', 'time': '2025-05-11T16:35:03.226Z'}, {'type': 's', 'time': '2025-05-11T16:35:05.768Z'}, {'type': 's', 'time': '2025-05-11T16:35:08.051Z'}, {'type': 's', 'time': '2025-05-11T16:35:11.577Z'}, {'type': 's', 'time': '2025-05-11T16:35:14.811Z'}, {'type': 'l', 'time': '2025-05-11T16:35:18.260Z'}, {'type': 's', 'time': '2025-05-11T16:35:21.576Z'}, {'type': 's', 'time': '2025-05-11T16:35:28.684Z'}, {'type': 'l', 'time': '2025-05-11T16:35:31.375Z'}, {'type': 's', 'time': '2025-05-11T16:35:34.517Z'}, {'type': 's', 'time': '2025-05-11T16:35:42.991Z'}, {'type': 's', 'time': '2025-05-11T16:35:50.202Z'}]",18,3,21,15
6,6,1,B. pascuorum,1746981441172,2025-05-11T16:37:21.172Z,1746981561172,2025-05-11T16:39:21.172Z,"[{'type': 's', 'time': '2025-05-11T16:37:25.580Z'}, {'type': 'l', 'time': '2025-05-11T16:37:29.519Z'}, {'type': 's', 'time': '2025-05-11T16:37:32.638Z'}, {'type': 's', 'time': '2025-05-11T16:37:34.221Z'}, {'type': 'l', 'time': '2025-05-11T16:37:36.313Z'}, {'type': 'l', 'time': '2025-05-11T16:37:38.020Z'}, {'type': 'l', 'time': '2025-05-11T16:37:40.953Z'}, {'type': 's', 'time': '2025-05-11T16:37:51.068Z'}, {'type': 's', 'time': '2025-05-11T16:37:54.352Z'}, {'type': 'l', 'time': '2025-05-11T16:37:58.038Z'}, {'type': 's', 'time': '2025-05-11T16:37:59.737Z'}, {'type': 's', 'time': '2025-05-11T16:38:03.001Z'}, {'type': 's', 'time': '2025-05-11T16:38:07.568Z'}, {'type': 'l', 'time': '2025-05-11T16:38:12.555Z'}, {'type': 's', 'time': '2025-05-11T16:38:25.625Z'}, {'type': 's', 'time': '2025-05-11T16:38:36.639Z'}, {'type': 's', 'time': '2025-05-11T16:38:41.608Z'}, {'type': 's', 'time': '2025-05-11T16:38:45.149Z'}, {'type': 's', 'time': '2025-05-11T16:38:49.534Z'}, {'type': 's', 'time': '2025-05-11T16:38:58.207Z'}, {'type': 's', 'time': '2025-05-11T16:39:01.235Z'}, {'type': 'l', 'time': '2025-05-11T16:39:03.981Z'}, {'type': 's', 'time': '2025-05-11T16:39:15.681Z'}, {'type': 's', 'time': '2025-05-11T16:39:20.497Z'}]",17,7,24,10
7,7,1,B. pascuorum,1746981634523,2025-05-11T16:40:34.523Z,1746981754523,2025-05-11T16:42:34.523Z,"[{'type': 's', 'time': '2025-05-11T16:40:44.652Z'}, {'type': 's', 'time': '2025-05-11T16:40:49.267Z'}, {'type': 's', 'time': '2025-05-11T16:40:55.759Z'}, {'type': 's', 'time': '2025-05-11T16:41:07.684Z'}, {'type': 'l', 'time': '2025-05-11T16:41:13.248Z'}, {'type': 's', 'time': '2025-05-11T16:41:19.133Z'}, {'type': 's', 'time': '2025-05-11T16:41:25.509Z'}, {'type': 's', 'time': '2025-05-11T16:41:30.683Z'}, {'type': 's', 'time': '2025-05-11T16:41:34.768Z'}, {'type': 'l', 'time': '2025-05-11T16:41:36.873Z'}, {'type': 's', 'time': '2025-05-11T16:41:44.292Z'}, {'type': 's', 'time': '2025-05-11T16:41:46.936Z'}, {'type': 'l', 'time': '2025-05-11T16:41:55.064Z'}, {'type': 's', 'time': '2025-05-11T16:41:59.104Z'}, {'type': 'l', 'time': '2025-05-11T16:42:01.021Z'}, {'type': 's', 'time': '2025-05-11T16:42:05.788Z'}, {'type': 's', 'time': '2025-05-11T16:42:06.930Z'}, {'type': 's', 'time': '2025-05-11T16:42:10.217Z'}, {'type': 's', 'time': '2025-05-11T16:42:12.245Z'}, {'type': 's', 'time': '2025-05-11T16:42:14.454Z'}, {'type': 's', 'time': '2025-05-11T16:42:21.117Z'}, {'type': 's', 'time': '2025-05-11T16:42:22.703Z'}, {'type': 's', 'time': '2025-05-11T16:42:28.144Z'}]",19,4,23,15
8,8,1,B. pascuorum,1746981788729,2025-05-11T16:43:08.729Z,1746981908729,2025-05-11T16:45:08.729Z,"[{'type': 's', 'time': '2025-05-11T16:43:14.211Z'}, {'type': 's', 'time': '2025-05-11T16:43:19.717Z'}, {'type': 's', 'time': '2025-05-11T16:43:22.515Z'}, {'type': 'l', 'time': '2025-05-11T16:43:25.242Z'}, {'type': 's', 'time': '2025-05-11T16:43:32.290Z'}, {'type': 's', 'time': '2025-05-11T16:43:36.473Z'}, {'type': 's', 'time': '2025-05-11T16:43:39.457Z'}, {'type': 's', 'time': '2025-05-11T16:43:42.682Z'}, {'type': 's', 'time': '2025-05-11T16:43:46.859Z'}, {'type': 'l', 'time': '2025-05-11T16:43:49.723Z'}, {'type': 's', 'time': '2025-05-11T16:43:53.812Z'}, {'type': 'l', 'time': '2025-05-11T16:43:57.055Z'}, {'type': 'l', 'time': '2025-05-11T16:44:01.614Z'}, {'type': 's', 'time': '2025-05-11T16:44:08.561Z'}, {'type': 's', 'time': '2025-05-11T16:44:16.437Z'}, {'type': 'l', 'time': '2025-05-11T16:44:18.629Z'}, {'type': 's', 'time': '2025-05-11T16:44:28.385Z'}, {'type': 's', 'time': '2025-05-11T16:44:38.662Z'}, {'type': 's', 'time': '2025-05-11T16:44:45.469Z'}, {'type': 's', 'time': '2025-05-11T16:44:47.652Z'}, {'type': 's', 'time': '2025-05-11T16:44:51.628Z'}, {'type': 'l', 'time': '2025-05-11T16:44:53.227Z'}, {'type': 'l', 'time': '2025-05-11T16:44:59.727Z'}, {'type': 'l', 'time': '2025-05-11T16:45:05.314Z'}]",16,8,24,8
9,9,1,B. pascuorum,1746981953065,2025-05-11T16:45:53.065Z,1746982073065,2025-05-11T16:47:53.065Z,"[{'type': 's', 'time': '2025-05-11T16:45:55.928Z'}, {'type': 'l', 'time': '2025-05-11T16:45:58.033Z'}, {'type': 's', 'time': '2025-05-11T16:46:01.497Z'}, {'type': 'l', 'time': '2025-05-11T16:46:06.621Z'}, {'type': 's', 'time': '2025-05-11T16:46:12.913Z'}, {'type': 's', 'time': '2025-05-11T16:46:14.677Z'}, {'type': 'l', 'time': '2025-05-11T16:46:16.592Z'}, {'type': 'l', 'time': '2025-05-11T16:46:26.812Z'}, {'type': 's', 'time': '2025-05-11T16:46:32.594Z'}, {'type': 's', 'time': '2025-05-11T16:46:34.328Z'}, {'type': 's', 'time': '2025-05-11T16:46:46.735Z'}, {'type': 's', 'time': '2025-05-11T16:46:53.793Z'}, {'type': 'l', 'time': '2025-05-11T16:46:57.062Z'}, {'type': 's', 'time': '2025-05-11T16:47:03.626Z'}, {'type': 's', 'time': '2025-05-11T16:47:08.594Z'}, {'type': 'l', 'time': '2025-05-11T16:47:14.391Z'}, {'type': 'l', 'time': '2025-05-11T16:47:17.116Z'}, {'type': 's', 'time': '2025-05-11T16:47:24.483Z'}, {'type': 'l', 'time': '2025-05-11T16:47:30.666Z'}, {'type': 'l', 'time': '2025-05-11T16:47:35.648Z'}, {'type': 's', 'time': '2025-05-11T16:47:38.648Z'}, {'type': 'l', 'time': '2025-05-11T16:47:42.663Z'}]",12,10,22,2
10,10,2,B. hypnorum,1747068432711,2025-05-12T16:47:12.711Z,1747068552711,2025-05-12T16:49:12.711Z,"[{'type': 'l', 'time': '2025-05-12T16:47:44.477Z'}, {'type': 's', 'time': '2025-05-12T16:47:47.860Z'}, {'type': 'l', 'time': '2025-05-12T16:47:53.276Z'}, {'type': 's', 'time': '2025-05-12T16:48:09.037Z'}, {'type': 's', 'time': '2025-05-12T16:48:19.458Z'}, {'type': 'l', 'time': '2025-05-12T16:48:24.198Z'}, {'type': 's', 'time': '2025-05-12T16:48:31.025Z'}, {'type': 'l', 'time': '2025-05-12T16:48:33.958Z'}, {'type': 'l', 'time': '2025-05-12T16:48:47.357Z'}, {'type': 's', 'time': '2025-05-12T16:48:55.108Z'}, {'type': 'l', 'time': '2025-05-12T16:48:59.699Z'}, {'type': 's', 'time': '2025-05-12T16:49:00.417Z'}]",6,6,12,0
11,11,2,B. pratorum,1747068764292,2025-05-12T16:52:44.292Z,1747068884292,2025-05-12T16:54:44.292Z,"[{'type': 'l', 'time': '2025-05-12T16:52:49.004Z'}, {'type': 's', 'time': '2025-05-12T16:52:52.493Z'}, {'type': 'l', 'time': '2025-05-12T16:52:57.199Z'}, {'type': 's', 'time': '2025-05-12T16:53:03.527Z'}, {'type': 's', 'time': '2025-05-12T16:53:24.442Z'}, {'type': 'l', 'time': '2025-05-12T16:53:31.802Z'}, {'type': 's', 'time': '2025-05-12T16:53:35.566Z'}, {'type': 's', 'time': '2025-05-12T16:53:51.608Z'}, {'type': 'l', 'time': '2025-05-12T16:53:57.066Z'}, {'type': 's', 'time': '2025-05-12T16:53:58.675Z'}, {'type': 's', 'time': '2025-05-12T16:54:07.233Z'}, {'type': 'l', 'time': '2025-05-12T16:54:11.765Z'}, {'type': 's', 'time': '2025-05-12T16:54:27.907Z'}, {'type': 'l', 'time': '2025-05-12T16:54:30.355Z'}, {'type': 's', 'time': '2025-05-12T16:54:33.714Z'}, {'type': 's', 'time': '2025-05-12T16:54:40.878Z'}]",10,6,16,4
12,12,2,B. hortorum,1747069077998,2025-05-12T16:57:57.998Z,1747069197998,2025-05-12T16:59:57.998Z,"[{'type': 's', 'time': '2025-05-12T16:58:00.701Z'}, {'type': 's', 'time': '2025-05-12T16:58:03.797Z'}, {'type': 's', 'time': '2025-05-12T16:58:07.689Z'}, {'type': 'l', 'time': '2025-05-12T16:58:10.289Z'}, {'type': 's', 'time': '2025-05-12T16:58:12.825Z'}, {'type': 's', 'time': '2025-05-12T16:58:14.714Z'}, {'type': 's', 'time': '2025-05-12T16:58:16.523Z'}, {'type': 's', 'time': '2025-05-12T16:58:17.976Z'}, {'type': 's', 'time': '2025-05-12T16:58:20.072Z'}, {'type': 'l', 'time': '2025-05-12T16:58:24.622Z'}, {'type': 's', 'time': '2025-05-12T16:58:27.020Z'}, {'type': 's', 'time': '2025-05-12T16:58:29.311Z'}, {'type': 'l', 'time': '2025-05-12T16:58:33.272Z'}, {'type': 's', 'time': '2025-05-12T16:58:37.461Z'}, {'type': 's', 'time': '2025-05-12T16:58:42.663Z'}, {'type': 's', 'time': '2025-05-12T16:58:47.304Z'}, {'type': 's', 'time': '2025-05-12T16:58:50.188Z'}, {'type': 'l', 'time': '2025-05-12T16:58:54.997Z'}, {'type': 's', 'time': '2025-05-12T16:58:58.395Z'}, {'type': 's', 'time': '2025-05-12T16:59:00.629Z'}, {'type': 's', 'time': '2025-05-12T16:59:02.561Z'}, {'type': 's', 'time': '2025-05-12T16:59:05.084Z'}, {'type': 'l', 'time': '2025-05-12T16:59:10.499Z'}, {'type': 's', 'time': '2025-05-12T16:59:13.245Z'}, {'type': 's', 'time': '2025-05-12T16:59:15.345Z'}, {'type': 's', 'time': '2025-05-12T16:59:17.287Z'}, {'type': 's', 'time': '2025-05-12T16:59:19.662Z'}, {'type': 's', 'time': '2025-05-12T16:59:22.222Z'}, {'type': 's', 'time': '2025-05-12T16:59:25.164Z'}, {'type': 's', 'time': '2025-05-12T16:59:27.711Z'}, {'type': 'l', 'time': '2025-05-12T16:59:30.984Z'}, {'type': 's', 'time': '2025-05-12T16:59:35.244Z'}, {'type': 's', 'time': '2025-05-12T16:59:37.319Z'}, {'type': 's', 'time': '2025-05-12T16:59:40.133Z'}, {'type': 's', 'time': '2025-05-12T16:59:44.411Z'}, {'type': 'l', 'time': '2025-05-12T16:59:46.212Z'}, {'type': 's', 'time': '2025-05-12T16:59:48.250Z'}]",30,7,37,23
13,13,2,B. hortorum,1747069253740,2025-05-12T17:00:53.740Z,1747069373740,2025-05-12T17:02:53.740Z,"[{'type': 'l', 'time': '2025-05-12T17:00:56.516Z'}, {'type': 'l', 'time': '2025-05-12T17:01:03.281Z'}, {'type': 'l', 'time': '2025-05-12T17:01:05.779Z'}, {'type': 'l', 'time': '2025-05-12T17:01:10.009Z'}, {'type': 's', 'time': '2025-05-12T17:01:14.464Z'}, {'type': 's', 'time': '2025-05-12T17:01:18.923Z'}, {'type': 's', 'time': '2025-05-12T17:01:24.904Z'}, {'type': 'l', 'time': '2025-05-12T17:01:27.966Z'}, {'type': 'l', 'time': '2025-05-12T17:01:34.739Z'}, {'type': 's', 'time': '2025-05-12T17:01:49.892Z'}, {'type': 's', 'time': '2025-05-12T17:01:54.544Z'}, {'type': 'l', 'time': '2025-05-12T17:01:58.022Z'}, {'type': 's', 'time': '2025-05-12T17:02:16.347Z'}, {'type': 's', 'time': '2025-05-12T17:02:20.479Z'}, {'type': 's', 'time': '2025-05-12T17:02:22.321Z'}, {'type': 'l', 'time': '2025-05-12T17:02:28.121Z'}, {'type': 's', 'time': '2025-05-12T17:02:42.388Z'}]",9,8,17,1
14,14,2,B. pascuorum,1747069398462,2025-05-12T17:03:18.462Z,1747069518462,2025-05-12T17:05:18.462Z,"[{'type': 's', 'time': '2025-05-12T17:03:23.894Z'}, {'type': 's', 'time': '2025-05-12T17:03:26.960Z'}, {'type': 's', 'time': '2025-05-12T17:03:39.976Z'}, {'type': 's', 'time': '2025-05-12T17:03:45.201Z'}, {'type': 'l', 'time': '2025-05-12T17:03:50.502Z'}, {'type': 's', 'time': '2025-05-12T17:03:52.409Z'}, {'type': 's', 'time': '2025-05-12T17:03:54.074Z'}, {'type': 's', 'time': '2025-05-12T17:03:57.632Z'}, {'type': 's', 'time': '2025-05-12T17:04:01.031Z'}, {'type': 's', 'time': '2025-05-12T17:04:07.026Z'}, {'type': 's', 'time': '2025-05-12T17:04:11.734Z'}, {'type': 'l', 'time': '2025-05-12T17:04:16.525Z'}, {'type': 'l', 'time': '2025-05-12T17:04:33.483Z'}, {'type': 's', 'time': '2025-05-12T17:04:36.466Z'}, {'type': 's', 'time': '2025-05-12T17:04:38.243Z'}, {'type': 's', 'time': '2025-05-12T17:04:44.274Z'}, {'type': 'l', 'time': '2025-05-12T17:04:50.514Z'}, {'type': 's', 'time': '2025-05-12T17:04:57.012Z'}, {'type': 's', 'time': '2025-05-12T17:05:07.096Z'}, {'type': 's', 'time': '2025-05-12T17:05:12.422Z'}, {'type': 's', 'time': '2025-05-12T17:05:15.374Z'}, {'type': 'l', 'time': '2025-05-12T17:05:18.032Z'}]",17,5,22,12
15,15,2,B. pascuorum,1747069765872,2025-05-12T17:09:25.872Z,1747069885872,2025-05-12T17:11:25.872Z,"[{'type': 's', 'time': '2025-05-12T17:09:28.926Z'}, {'type': 's', 'time': '2025-05-12T17:09:37.004Z'}, {'type': 's', 'time': '2025-05-12T17:09:46.951Z'}, {'type': 's', 'time': '2025-05-12T17:09:56.954Z'}, {'type': 's', 'time': '2025-05-12T17:10:01.496Z'}, {'type': 's', 'time': '2025-05-12T17:10:14.112Z'}, {'type': 'l', 'time': '2025-05-12T17:10:19.467Z'}, {'type': 'l', 'time': '2025-05-12T17:10:25.511Z'}, {'type': 's', 'time': '2025-05-12T17:10:28.270Z'}, {'type': 's', 'time': '2025-05-12T17:10:31.877Z'}, {'type': 'l', 'time': '2025-05-12T17:10:35.810Z'}, {'type': 'l', 'time': '2025-05-12T17:10:38.965Z'}, {'type': 's', 'time': '2025-05-12T17:10:43.368Z'}, {'type': 'l', 'time': '2025-05-12T17:10:47.018Z'}, {'type': 's', 'time': '2025-05-12T17:10:52.385Z'}, {'type': 's', 'time': '2025-05-12T17:10:55.402Z'}, {'type': 'l', 'time': '2025-05-12T17:11:00.356Z'}, {'type': 'l', 'time': '2025-05-12T17:11:03.785Z'}, {'type': 'l', 'time': '2025-05-12T17:11:07.302Z'}, {'type': 's', 'time': '2025-05-12T17:11:09.118Z'}, {'type': 's', 'time': '2025-05-12T17:11:11.868Z'}, {'type': 'l', 'time': '2025-05-12T17:11:14.862Z'}, {'type': 's', 'time': '2025-05-12T17:11:20.691Z'}]",14,9,23,5
16,16,2,B. pratorum,1747070178439,2025-05-12T17:16:18.439Z,1747070298439,2025-05-12T17:18:18.439Z,"[{'type': 's', 'time': '2025-05-12T17:16:20.839Z'}, {'type': 's', 'time': '2025-05-12T17:16:26.714Z'}, {'type': 'l', 'time': '2025-05-12T17:16:28.732Z'}, {'type': 's', 'time': '2025-05-12T17:16:30.240Z'}, {'type': 's', 'time': '2025-05-12T17:16:34.017Z'}, {'type': 's', 'time': '2025-05-12T17:16:42.498Z'}, {'type': 's', 'time': '2025-05-12T17:17:16.495Z'}, {'type': 's', 'time': '2025-05-12T17:17:24.002Z'}, {'type': 's', 'time': '2025-05-12T17:17:31.605Z'}, {'type': 's', 'time': '2025-05-12T17:17:43.634Z'}, {'type': 'l', 'time': '2025-05-12T17:17:47.835Z'}, {'type': 's', 'time': '2025-05-12T17:18:00.046Z'}, {'type': 's', 'time': '2025-05-12T17:18:09.121Z'}, {'type': 's', 'time': '2025-05-12T17:18:16.671Z'}]",12,2,14,10
17,17,2,B. hypnorum,1747070711617,2025-05-12T17:25:11.617Z,1747070831617,2025-05-12T17:27:11.617Z,"[{'type': 's', 'time': '2025-05-12T17:25:16.601Z'}, {'type': 'l', 'time': '2025-05-12T17:25:33.150Z'}, {'type': 's', 'time': '2025-05-12T17:25:35.835Z'}, {'type': 'l', 'time': '2025-05-12T17:25:40.017Z'}, {'type': 's', 'time': '2025-05-12T17:25:44.282Z'}, {'type': 's', 'time': '2025-05-12T17:25:46.715Z'}, {'type': 's', 'time': '2025-05-12T17:25:57.541Z'}, {'type': 'l', 'time': '2025-05-12T17:26:05.208Z'}, {'type': 's', 'time': '2025-05-12T17:26:08.550Z'}, {'type': 's', 'time': '2025-05-12T17:26:16.068Z'}, {'type': 'l', 'time': '2025-05-12T17:26:23.795Z'}, {'type': 'l', 'time': '2025-05-12T17:26:40.386Z'}, {'type': 's', 'time': '2025-05-12T17:26:54.465Z'}, {'type': 'l', 'time': '2025-05-12T17:26:58.796Z'}, {'type': 's', 'time': '2025-05-12T17:27:06.171Z'}]",9,6,15,3
18,18,2,B. jonellus,1747070972624,2025-05-12T17:29:32.624Z,1747071092624,2025-05-12T17:31:32.624Z,"[{'type': 's', 'time': '2025-05-12T17:29:34.575Z'}, {'type': 'l', 'time': '2025-05-12T17:29:38.339Z'}, {'type': 'l', 'time': '2025-05-12T17:29:40.435Z'}, {'type': 's', 'time': '2025-05-12T17:29:46.002Z'}, {'type': 's', 'time': '2025-05-12T17:29:51.397Z'}, {'type': 's', 'time': '2025-05-12T17:29:56.766Z'}, {'type': 's', 'time': '2025-05-12T17:30:04.079Z'}, {'type': 'l', 'time': '2025-05-12T17:30:16.228Z'}, {'type': 's', 'time': '2025-05-12T17:30:35.494Z'}, {'type': 's', 'time': '2025-05-12T17:30:40.786Z'}, {'type': 'l', 'time': '2025-05-12T17:30:48.469Z'}, {'type': 's', 'time': '2025-05-12T17:30:54.393Z'}, {'type': 'l', 'time': '2025-05-12T17:31:08.052Z'}, {'type': 's', 'time': '2025-05-12T17:31:11.692Z'}, {'type': 'l', 'time': '2025-05-12T17:31:20.725Z'}, {'type': 'l', 'time': '2025-05-12T17:31:26.309Z'}, {'type': 's', 'time': '2025-05-12T17:31:32.645Z'}]",10,7,17,3
19,19,2,B. jonellus,1747071251784,2025-05-12T17:34:11.785Z,1747071371784,2025-05-12T17:36:11.784Z,"[{'type': 'l', 'time': '2025-05-12T17:34:17.977Z'}, {'type': 's', 'time': '2025-05-12T17:34:26.144Z'}, {'type': 's', 'time': '2025-05-12T17:34:27.344Z'}, {'type': 's', 'time': '2025-05-12T17:34:31.610Z'}, {'type': 'l', 'time': '2025-05-12T17:34:40.038Z'}, {'type': 's', 'time': '2025-05-12T17:34:42.868Z'}, {'type': 's', 'time': '2025-05-12T17:34:48.365Z'}, {'type': 's', 'time': '2025-05-12T17:34:55.673Z'}, {'type': 's', 'time': '2025-05-12T17:35:00.636Z'}, {'type': 'l', 'time': '2025-05-12T17:35:05.934Z'}, {'type': 's', 'time': '2025-05-12T17:35:09.622Z'}, {'type': 'l', 'time': '2025-05-12T17:35:16.106Z'}, {'type': 's', 'time': '2025-05-12T17:35:22.955Z'}, {'type': 'l', 'time': '2025-05-12T17:35:26.663Z'}, {'type': 'l', 'time': '2025-05-12T17:35:39.132Z'}, {'type': 'l', 'time': '2025-05-12T17:35:46.721Z'}, {'type': 'l', 'time': '2025-05-12T17:35:55.938Z'}, {'type': 's', 'time': '2025-05-12T17:35:59.130Z'}, {'type': 's', 'time': '2025-05-12T17:36:05.217Z'}]",11,8,19,3
20,20,3,B. pascuorum,1747155519187,2025-05-13T16:58:39.187Z,1747155639187,2025-05-13T17:00:39.187Z,"[{'type': 'l', 'time': '2025-05-13T16:58:48.073Z'}, {'type': 's', 'time': '2025-05-13T16:58:50.776Z'}, {'type': 'l', 'time': '2025-05-13T16:58:53.403Z'}, {'type': 'l', 'time': '2025-05-13T16:58:56.223Z'}, {'type': 'l', 'time': '2025-05-13T16:58:59.607Z'}, {'type': 'l', 'time': '2025-05-13T16:59:03.309Z'}, {'type': 's', 'time': '2025-05-13T16:59:05.831Z'}, {'type': 'l', 'time': '2025-05-13T16:59:12.677Z'}, {'type': 'l', 'time': '2025-05-13T16:59:15.199Z'}, {'type': 'l', 'time': '2025-05-13T16:59:23.765Z'}, {'type': 's', 'time': '2025-05-13T16:59:32.272Z'}, {'type': 's', 'time': '2025-05-13T16:59:33.474Z'}, {'type': 'l', 'time': '2025-05-13T16:59:40.344Z'}, {'type': 's', 'time': '2025-05-13T16:59:52.865Z'}, {'type': 's', 'time': '2025-05-13T16:59:56.781Z'}, {'type': 'l', 'time': '2025-05-13T17:00:01.065Z'}, {'type': 'l', 'time': '2025-05-13T17:00:05.327Z'}, {'type': 's', 'time': '2025-05-13T17:00:09.681Z'}, {'type': 's', 'time': '2025-05-13T17:00:14.331Z'}, {'type': 'l', 'time': '2025-05-13T17:00:22.555Z'}, {'type': 's', 'time': '2025-05-13T17:00:24.461Z'}, {'type': 's', 'time': '2025-05-13T17:00:32.005Z'}, {'type': 's', 'time': '2025-05-13T17:00:37.671Z'}]",11,12,23,-1
21,21,3,B. hypnorum,1747155706409,2025-05-13T17:01:46.409Z,1747155826409,2025-05-13T17:03:46.409Z,"[{'type': 'l', 'time': '2025-05-13T17:01:52.983Z'}, {'type': 'l', 'time': '2025-05-13T17:01:55.299Z'}, {'type': 's', 'time': '2025-05-13T17:01:58.826Z'}, {'type': 's', 'time': '2025-05-13T17:02:00.354Z'}, {'type': 'l', 'time': '2025-05-13T17:02:04.432Z'}, {'type': 'l', 'time': '2025-05-13T17:02:10.230Z'}, {'type': 's', 'time': '2025-05-13T17:02:11.348Z'}, {'type': 's', 'time': '2025-05-13T17:02:15.323Z'}, {'type': 's', 'time': '2025-05-13T17:02:17.040Z'}, {'type': 'l', 'time': '2025-05-13T17:02:23.952Z'}, {'type': 's', 'time': '2025-05-13T17:03:25.241Z'}, {'type': 's', 'time': '2025-05-13T17:03:30.106Z'}, {'type': 'l', 'time': '2025-05-13T17:03:41.159Z'}, {'type': 's', 'time': '2025-05-13T17:03:45.612Z'}]",8,6,14,2
22,22,3,B. campestris,1747155959827,2025-05-13T17:05:59.828Z,1747156079827,2025-05-13T17:07:59.827Z,"[{'type': 's', 'time': '2025-05-13T17:06:03.510Z'}, {'type': 'l', 'time': '2025-05-13T17:06:06.553Z'}, {'type': 's', 'time': '2025-05-13T17:06:14.856Z'}, {'type': 's', 'time': '2025-05-13T17:06:22.433Z'}, {'type': 's', 'time': '2025-05-13T17:06:32.751Z'}, {'type': 's', 'time': '2025-05-13T17:06:47.977Z'}, {'type': 's', 'time': '2025-05-13T17:06:56.121Z'}, {'type': 'l', 'time': '2025-05-13T17:07:05.757Z'}, {'type': 's', 'time': '2025-05-13T17:07:12.214Z'}, {'type': 's', 'time': '2025-05-13T17:07:14.913Z'}, {'type': 's', 'time': '2025-05-13T17:07:21.915Z'}, {'type': 'l', 'time': '2025-05-13T17:07:27.712Z'}, {'type': 'l', 'time': '2025-05-13T17:07:34.663Z'}, {'type': 's', 'time': '2025-05-13T17:07:56.387Z'}]",10,4,14,6
23,23,3,B. hypnorum,1747156225604,2025-05-13T17:10:25.604Z,1747156345604,2025-05-13T17:12:25.604Z,"[{'type': 's', 'time': '2025-05-13T17:10:31.872Z'}, {'type': 's', 'time': '2025-05-13T17:10:38.363Z'}, {'type': 'l', 'time': '2025-05-13T17:10:43.813Z'}, {'type': 's', 'time': '2025-05-13T17:10:52.001Z'}, {'type': 'l', 'time': '2025-05-13T17:11:13.013Z'}, {'type': 's', 'time': '2025-05-13T17:11:23.076Z'}, {'type': 's', 'time': '2025-05-13T17:11:57.968Z'}, {'type': 's', 'time': '2025-05-13T17:12:02.303Z'}, {'type': 'l', 'time': '2025-05-13T17:12:15.792Z'}, {'type': 's', 'time': '2025-05-13T17:12:23.842Z'}, {'type': 'l', 'time': '2025-05-13T17:12:25.184Z'}]",7,4,11,3
24,24,3,B. campestris,1747156494919,2025-05-13T17:14:54.919Z,1747156614919,2025-05-13T17:16:54.919Z,"[{'type': 'l', 'time': '2025-05-13T17:14:58.293Z'}, {'type': 'l', 'time': '2025-05-13T17:15:03.063Z'}, {'type': 's', 'time': '2025-05-13T17:15:09.043Z'}, {'type': 's', 'time': '2025-05-13T17:15:19.449Z'}, {'type': 's', 'time': '2025-05-13T17:15:22.817Z'}, {'type': 'l', 'time': '2025-05-13T17:15:29.675Z'}, {'type': 's', 'time': '2025-05-13T17:15:33.008Z'}, {'type': 'l', 'time': '2025-05-13T17:15:40.861Z'}, {'type': 'l', 'time': '2025-05-13T17:15:45.938Z'}, {'type': 'l', 'time': '2025-05-13T17:15:50.583Z'}, {'type': 's', 'time': '2025-05-13T17:15:53.819Z'}, {'type': 's', 'time': '2025-05-13T17:15:55.057Z'}, {'type': 's', 'time': '2025-05-13T17:15:59.558Z'}, {'type': 'l', 'time': '2025-05-13T17:16:01.137Z'}, {'type': 's', 'time': '2025-05-13T17:16:04.890Z'}, {'type': 's', 'time': '2025-05-13T17:16:07.312Z'}, {'type': 'l', 'time': '2025-05-13T17:16:28.845Z'}, {'type': 's', 'time': '2025-05-13T17:16:36.714Z'}, {'type': 's', 'time': '2025-05-13T17:16:40.754Z'}, {'type': 'l', 'time': '2025-05-13T17:16:43.398Z'}, {'type': 's', 'time': '2025-05-13T17:16:50.737Z'}]",12,9,21,3
25,25,3,B. hortorum,1747156643821,2025-05-13T17:17:23.821Z,1747156763821,2025-05-13T17:19:23.821Z,"[{'type': 's', 'time': '2025-05-13T17:17:32.610Z'}, {'type': 's', 'time': '2025-05-13T17:17:35.453Z'}, {'type': 'l', 'time': '2025-05-13T17:17:36.885Z'}, {'type': 's', 'time': '2025-05-13T17:17:38.437Z'}, {'type': 's', 'time': '2025-05-13T17:17:40.753Z'}, {'type': 'l', 'time': '2025-05-13T17:17:42.826Z'}, {'type': 's', 'time': '2025-05-13T17:17:44.503Z'}, {'type': 's', 'time': '2025-05-13T17:17:46.978Z'}, {'type': 's', 'time': '2025-05-13T17:17:49.903Z'}, {'type': 'l', 'time': '2025-05-13T17:17:51.411Z'}, {'type': 's', 'time': '2025-05-13T17:17:52.328Z'}, {'type': 's', 'time': '2025-05-13T17:17:55.625Z'}, {'type': 's', 'time': '2025-05-13T17:17:57.970Z'}, {'type': 'l', 'time': '2025-05-13T17:18:01.399Z'}, {'type': 's', 'time': '2025-05-13T17:18:05.035Z'}, {'type': 's', 'time': '2025-05-13T17:18:08.225Z'}, {'type': 's', 'time': '2025-05-13T17:18:11.235Z'}, {'type': 'l', 'time': '2025-05-13T17:18:14.164Z'}, {'type': 's', 'time': '2025-05-13T17:18:15.998Z'}, {'type': 's', 'time': '2025-05-13T17:18:17.898Z'}, {'type': 's', 'time': '2025-05-13T17:18:20.852Z'}, {'type': 'l', 'time': '2025-05-13T17:18:28.621Z'}, {'type': 'l', 'time': '2025-05-13T17:18:32.134Z'}, {'type': 's', 'time': '2025-05-13T17:18:33.692Z'}, {'type': 's', 'time': '2025-05-13T17:18:35.365Z'}, {'type': 's', 'time': '2025-05-13T17:18:37.075Z'}, {'type': 's', 'time': '2025-05-13T17:18:39.611Z'}, {'type': 'l', 'time': '2025-05-13T17:18:42.400Z'}, {'type': 's', 'time': '2025-05-13T17:18:44.525Z'}, {'type': 's', 'time': '2025-05-13T17:18:47.981Z'}, {'type': 's', 'time': '2025-05-13T17:18:49.517Z'}, {'type': 's', 'time': '2025-05-13T17:18:51.259Z'}, {'type': 's', 'time': '2025-05-13T17:18:54.297Z'}, {'type': 'l', 'time': '2025-05-13T17:18:57.372Z'}, {'type': 's', 'time': '2025-05-13T17:18:58.674Z'}, {'type': 's', 'time': '2025-05-13T17:19:01.334Z'}, {'type': 's', 'time': '2025-05-13T17:19:05.643Z'}, {'type': 'l', 'time': '2025-05-13T17:19:11.015Z'}, {'type': 's', 'time': '2025-05-13T17:19:13.005Z'}, {'type': 's', 'time': '2025-05-13T17:19:14.595Z'}, {'type': 's', 'time': '2025-05-13T17:19:16.981Z'}, {'type': 'l', 'time': '2025-05-13T17:19:23.407Z'}]",31,11,42,20
26,26,3,B. pascuorum,1747156804878,2025-05-13T17:20:04.878Z,1747156924878,2025-05-13T17:22:04.878Z,"[{'type': 's', 'time': '2025-05-13T17:20:06.579Z'}, {'type': 's', 'time': '2025-05-13T17:20:10.832Z'}, {'type': 'l', 'time': '2025-05-13T17:20:13.352Z'}, {'type': 's', 'time': '2025-05-13T17:20:27.846Z'}, {'type': 's', 'time': '2025-05-13T17:20:35.396Z'}, {'type': 's', 'time': '2025-05-13T17:20:39.194Z'}, {'type': 's', 'time': '2025-05-13T17:20:41.843Z'}, {'type': 's', 'time': '2025-05-13T17:20:43.859Z'}, {'type': 's', 'time': '2025-05-13T17:20:44.848Z'}, {'type': 's', 'time': '2025-05-13T17:20:51.379Z'}, {'type': 's', 'time': '2025-05-13T17:20:56.727Z'}, {'type': 'l', 'time': '2025-05-13T17:21:02.624Z'}, {'type': 's', 'time': '2025-05-13T17:21:06.834Z'}, {'type': 's', 'time': '2025-05-13T17:21:12.636Z'}, {'type': 's', 'time': '2025-05-13T17:21:18.622Z'}, {'type': 's', 'time': '2025-05-13T17:21:24.999Z'}, {'type': 's', 'time': '2025-05-13T17:21:27.330Z'}, {'type': 's', 'time': '2025-05-13T17:21:30.001Z'}, {'type': 's', 'time': '2025-05-13T17:21:34.099Z'}, {'type': 's', 'time': '2025-05-13T17:21:38.781Z'}, {'type': 's', 'time': '2025-05-13T17:21:40.015Z'}, {'type': 's', 'time': '2025-05-13T17:21:41.425Z'}, {'type': 'l', 'time': '2025-05-13T17:21:45.192Z'}, {'type': 's', 'time': '2025-05-13T17:21:52.751Z'}, {'type': 's', 'time': '2025-05-13T17:21:56.633Z'}, {'type': 's', 'time': '2025-05-13T17:22:01.834Z'}, {'type': 's', 'time': '2025-05-13T17:22:04.482Z'}]",24,3,27,21
27,27,3,B. pascuorum,1747156976540,2025-05-13T17:22:56.540Z,1747157096540,2025-05-13T17:24:56.540Z,"[{'type': 's', 'time': '2025-05-13T17:23:03.487Z'}, {'type': 'l', 'time': '2025-05-13T17:23:06.056Z'}, {'type': 's', 'time': '2025-05-13T17:23:25.780Z'}, {'type': 'l', 'time': '2025-05-13T17:23:35.353Z'}, {'type': 'l', 'time': '2025-05-13T17:23:47.491Z'}, {'type': 's', 'time': '2025-05-13T17:24:01.618Z'}, {'type': 'l', 'time': '2025-05-13T17:24:05.616Z'}, {'type': 'l', 'time': '2025-05-13T17:24:10.752Z'}, {'type': 's', 'time': '2025-05-13T17:24:20.417Z'}, {'type': 'l', 'time': '2025-05-13T17:24:29.451Z'}, {'type': 's', 'time': '2025-05-13T17:24:38.135Z'}]",5,6,11,-1
28,28,3,B. pascuorum,1747157163976,2025-05-13T17:26:03.976Z,1747157283976,2025-05-13T17:28:03.976Z,"[{'type': 's', 'time': '2025-05-13T17:26:09.197Z'}, {'type': 's', 'time': '2025-05-13T17:26:13.746Z'}, {'type': 'l', 'time': '2025-05-13T17:26:18.763Z'}, {'type': 'l', 'time': '2025-05-13T17:26:21.386Z'}, {'type': 's', 'time': '2025-05-13T17:26:27.661Z'}, {'type': 'l', 'time': '2025-05-13T17:26:35.553Z'}, {'type': 's', 'time': '2025-05-13T17:26:39.846Z'}, {'type': 's', 'time': '2025-05-13T17:26:42.882Z'}, {'type': 's', 'time': '2025-05-13T17:26:46.032Z'}, {'type': 'l', 'time': '2025-05-13T17:26:55.329Z'}, {'type': 's', 'time': '2025-05-13T17:27:01.029Z'}, {'type': 's', 'time': '2025-05-13T17:27:06.754Z'}, {'type': 's', 'time': '2025-05-13T17:27:11.277Z'}, {'type': 'l', 'time': '2025-05-13T17:27:14.067Z'}, {'type': 's', 'time': '2025-05-13T17:27:15.958Z'}, {'type': 's', 'time': '2025-05-13T17:27:21.950Z'}, {'type': 'l', 'time': '2025-05-13T17:27:27.208Z'}, {'type': 's', 'time': '2025-05-13T17:27:31.091Z'}, {'type': 'l', 'time': '2025-05-13T17:27:32.120Z'}, {'type': 's', 'time': '2025-05-13T17:27:34.952Z'}, {'type': 's', 'time': '2025-05-13T17:27:39.034Z'}, {'type': 'l', 'time': '2025-05-13T17:27:45.981Z'}, {'type': 's', 'time': '2025-05-13T17:27:47.269Z'}, {'type': 's', 'time': '2025-05-13T17:27:48.949Z'}, {'type': 'l', 'time': '2025-05-13T17:27:50.150Z'}, {'type': 's', 'time': '2025-05-13T17:27:55.352Z'}, {'type': 's', 'time': '2025-05-13T17:27:59.749Z'}, {'type': 's', 'time': '2025-05-13T17:28:01.743Z'}]",19,9,28,10
29,29,3,B. pascuorum,1747157326123,2025-05-13T17:28:46.123Z,1747157446123,2025-05-13T17:30:46.123Z,"[{'type': 'l', 'time': '2025-05-13T17:28:48.642Z'}, {'type': 's', 'time': '2025-05-13T17:28:50.599Z'}, {'type': 'l', 'time': '2025-05-13T17:28:56.579Z'}, {'type': 's', 'time': '2025-05-13T17:29:04.082Z'}, {'type': 's', 'time': '2025-05-13T17:29:32.159Z'}, {'type': 'l', 'time': '2025-05-13T17:29:43.369Z'}, {'type': 's', 'time': '2025-05-13T17:29:45.018Z'}, {'type': 's', 'time': '2025-05-13T17:29:59.588Z'}, {'type': 's', 'time': '2025-05-13T17:30:01.953Z'}]",6,3,9,3
30,30,4,B. pascuorum,1747241794377,2025-05-14T16:56:34.377Z,1747241914377,2025-05-14T16:58:34.377Z,"[{'type': 'l', 'time': '2025-05-14T16:56:35.210Z'}, {'type': 's', 'time': '2025-05-14T16:56:52.075Z'}, {'type': 'l', 'time': '2025-05-14T16:57:01.609Z'}, {'type': 's', 'time': '2025-05-14T16:57:06.033Z'}, {'type': 's', 'time': '2025-05-14T16:57:12.032Z'}, {'type': 's', 'time': '2025-05-14T16:57:14.543Z'}, {'type': 's', 'time': '2025-05-14T16:57:17.748Z'}, {'type': 'l', 'time': '2025-05-14T16:57:25.874Z'}, {'type': 's', 'time': '2025-05-14T16:57:29.008Z'}, {'type': 's', 'time': '2025-05-14T16:57:32.698Z'}, {'type': 's', 'time': '2025-05-14T16:57:38.099Z'}, {'type': 'l', 'time': '2025-05-14T16:57:42.646Z'}, {'type': 's', 'time': '2025-05-14T16:57:48.240Z'}, {'type': 's', 'time': '2025-05-14T16:57:51.847Z'}, {'type': 's', 'time': '2025-05-14T16:57:55.880Z'}, {'type': 's', 'time': '2025-05-14T16:58:06.230Z'}, {'type': 's', 'time': '2025-05-14T16:58:11.896Z'}, {'type': 'l', 'time': '2025-05-14T16:58:18.362Z'}, {'type': 'l', 'time': '2025-05-14T16:58:29.878Z'}, {'type': 's', 'time': '2025-05-14T16:58:31.684Z'}]",14,6,20,8
31,31,4,B. pascuorum,1747241990116,2025-05-14T16:59:50.116Z,1747242110116,2025-05-14T17:01:50.116Z,"[{'type': 'l', 'time': '2025-05-14T16:59:53.484Z'}, {'type': 's', 'time': '2025-05-14T16:59:57.025Z'}, {'type': 's', 'time': '2025-05-14T17:00:01.398Z'}, {'type': 'l', 'time': '2025-05-14T17:00:02.962Z'}, {'type': 's', 'time': '2025-05-14T17:00:06.468Z'}, {'type': 'l', 'time': '2025-05-14T17:00:13.941Z'}, {'type': 's', 'time': '2025-05-14T17:00:19.140Z'}, {'type': 's', 'time': '2025-05-14T17:00:23.262Z'}, {'type': 's', 'time': '2025-05-14T17:00:26.465Z'}, {'type': 'l', 'time': '2025-05-14T17:00:29.840Z'}, {'type': 'l', 'time': '2025-05-14T17:00:48.981Z'}, {'type': 'l', 'time': '2025-05-14T17:00:57.903Z'}, {'type': 's', 'time': '2025-05-14T17:01:00.572Z'}, {'type': 'l', 'time': '2025-05-14T17:01:09.114Z'}, {'type': 's', 'time': '2025-05-14T17:01:22.779Z'}, {'type': 's', 'time': '2025-05-14T17:01:24.629Z'}, {'type': 'l', 'time': '2025-05-14T17:01:34.029Z'}, {'type': 'l', 'time': '2025-05-14T17:01:37.812Z'}]",9,9,18,0
32,32,4,B. pascuorum,1747242136661,2025-05-14T17:02:16.661Z,1747242256661,2025-05-14T17:04:16.661Z,"[{'type': 's', 'time': '2025-05-14T17:02:23.135Z'}, {'type': 's', 'time': '2025-05-14T17:02:26.234Z'}, {'type': 'l', 'time': '2025-05-14T17:02:27.364Z'}, {'type': 's', 'time': '2025-05-14T17:02:32.478Z'}, {'type': 'l', 'time': '2025-05-14T17:02:35.790Z'}, {'type': 's', 'time': '2025-05-14T17:02:40.418Z'}, {'type': 's', 'time': '2025-05-14T17:02:46.732Z'}, {'type': 'l', 'time': '2025-05-14T17:02:50.875Z'}, {'type': 's', 'time': '2025-05-14T17:02:53.641Z'}, {'type': 's', 'time': '2025-05-14T17:03:04.591Z'}, {'type': 'l', 'time': '2025-05-14T17:03:08.805Z'}, {'type': 's', 'time': '2025-05-14T17:03:13.224Z'}, {'type': 's', 'time': '2025-05-14T17:03:19.530Z'}, {'type': 's', 'time': '2025-05-14T17:03:23.023Z'}, {'type': 's', 'time': '2025-05-14T17:03:26.580Z'}, {'type': 's', 'time': '2025-05-14T17:03:30.031Z'}, {'type': 's', 'time': '2025-05-14T17:03:33.163Z'}, {'type': 's', 'time': '2025-05-14T17:03:35.939Z'}, {'type': 's', 'time': '2025-05-14T17:03:39.214Z'}, {'type': 'l', 'time': '2025-05-14T17:03:42.038Z'}, {'type': 's', 'time': '2025-05-14T17:03:44.934Z'}, {'type': 's', 'time': '2025-05-14T17:03:51.254Z'}, {'type': 's', 'time': '2025-05-14T17:03:53.776Z'}, {'type': 's', 'time': '2025-05-14T17:03:57.820Z'}, {'type': 's', 'time': '2025-05-14T17:03:59.454Z'}, {'type': 's', 'time': '2025-05-14T17:04:01.513Z'}, {'type': 'l', 'time': '2025-05-14T17:04:03.563Z'}, {'type': 's', 'time': '2025-05-14T17:04:10.578Z'}]",22,6,28,16
33,33,4,B. pratorum,1747242288768,2025-05-14T17:04:48.768Z,1747242408768,2025-05-14T17:06:48.768Z,"[{'type': 's', 'time': '2025-05-14T17:04:57.127Z'}, {'type': 's', 'time': '2025-05-14T17:05:11.176Z'}, {'type': 's', 'time': '2025-05-14T17:05:19.776Z'}, {'type': 's', 'time': '2025-05-14T17:05:26.167Z'}, {'type': 's', 'time': '2025-05-14T17:05:28.092Z'}, {'type': 's', 'time': '2025-05-14T17:05:35.758Z'}, {'type': 'l', 'time': '2025-05-14T17:05:48.558Z'}, {'type': 's', 'time': '2025-05-14T17:05:52.139Z'}, {'type': 'l', 'time': '2025-05-14T17:05:58.531Z'}, {'type': 's', 'time': '2025-05-14T17:06:02.589Z'}, {'type': 'l', 'time': '2025-05-14T17:06:06.232Z'}, {'type': 'l', 'time': '2025-05-14T17:06:10.357Z'}, {'type': 'l', 'time': '2025-05-14T17:06:18.059Z'}, {'type': 's', 'time': '2025-05-14T17:06:20.265Z'}, {'type': 'l', 'time': '2025-05-14T17:06:27.381Z'}, {'type': 's', 'time': '2025-05-14T17:06:31.039Z'}, {'type': 's', 'time': '2025-05-14T17:06:37.997Z'}, {'type': 's', 'time': '2025-05-14T17:06:40.071Z'}, {'type': 'l', 'time': '2025-05-14T17:06:42.021Z'}]",12,7,19,5
34,34,4,B. hortorum,1747242504959,2025-05-14T17:08:24.959Z,1747242624959,2025-05-14T17:10:24.959Z,"[{'type': 's', 'time': '2025-05-14T17:08:27.717Z'}, {'type': 'l', 'time': '2025-05-14T17:08:32.133Z'}, {'type': 's', 'time': '2025-05-14T17:08:36.416Z'}, {'type': 's', 'time': '2025-05-14T17:08:38.289Z'}, {'type': 'l', 'time': '2025-05-14T17:08:44.982Z'}, {'type': 's', 'time': '2025-05-14T17:08:49.799Z'}, {'type': 'l', 'time': '2025-05-14T17:08:54.004Z'}, {'type': 's', 'time': '2025-05-14T17:08:57.565Z'}, {'type': 's', 'time': '2025-05-14T17:09:02.906Z'}, {'type': 'l', 'time': '2025-05-14T17:09:08.398Z'}, {'type': 's', 'time': '2025-05-14T17:09:11.198Z'}, {'type': 's', 'time': '2025-05-14T17:09:14.307Z'}, {'type': 's', 'time': '2025-05-14T17:09:17.847Z'}, {'type': 's', 'time': '2025-05-14T17:09:21.364Z'}, {'type': 's', 'time': '2025-05-14T17:09:24.808Z'}, {'type': 'l', 'time': '2025-05-14T17:09:32.425Z'}, {'type': 's', 'time': '2025-05-14T17:09:35.271Z'}, {'type': 'l', 'time': '2025-05-14T17:09:41.413Z'}, {'type': 's', 'time': '2025-05-14T17:09:44.185Z'}, {'type': 's', 'time': '2025-05-14T17:09:46.130Z'}, {'type': 'l', 'time': '2025-05-14T17:09:52.188Z'}, {'type': 's', 'time': '2025-05-14T17:10:01.718Z'}, {'type': 's', 'time': '2025-05-14T17:10:04.829Z'}, {'type': 's', 'time': '2025-05-14T17:10:08.368Z'}, {'type': 's', 'time': '2025-05-14T17:10:14.137Z'}, {'type': 's', 'time': '2025-05-14T17:10:15.786Z'}, {'type': 'l', 'time': '2025-05-14T17:10:19.428Z'}]",19,8,27,11
35,35,4,B. hortorum,1747242715999,2025-05-14T17:11:55.999Z,1747242835999,2025-05-14T17:13:55.999Z,"[{'type': 'l', 'time': '2025-05-14T17:12:00.899Z'}, {'type': 's', 'time': '2025-05-14T17:12:09.931Z'}, {'type': 's', 'time': '2025-05-14T17:12:21.530Z'}, {'type': 's', 'time': '2025-05-14T17:12:26.835Z'}, {'type': 'l', 'time': '2025-05-14T17:12:32.164Z'}, {'type': 'l', 'time': '2025-05-14T17:12:38.846Z'}, {'type': 's', 'time': '2025-05-14T17:12:43.304Z'}, {'type': 's', 'time': '2025-05-14T17:12:45.862Z'}, {'type': 's', 'time': '2025-05-14T17:12:50.920Z'}, {'type': 's', 'time': '2025-05-14T17:12:53.485Z'}, {'type': 's', 'time': '2025-05-14T17:12:56.787Z'}, {'type': 'l', 'time': '2025-05-14T17:13:02.195Z'}, {'type': 's', 'time': '2025-05-14T17:13:04.579Z'}, {'type': 's', 'time': '2025-05-14T17:13:07.062Z'}, {'type': 's', 'time': '2025-05-14T17:13:10.711Z'}, {'type': 's', 'time': '2025-05-14T17:13:14.587Z'}, {'type': 's', 'time': '2025-05-14T17:13:16.578Z'}, {'type': 's', 'time': '2025-05-14T17:13:18.729Z'}, {'type': 'l', 'time': '2025-05-14T17:13:23.803Z'}, {'type': 's', 'time': '2025-05-14T17:13:27.539Z'}, {'type': 's', 'time': '2025-05-14T17:13:30.862Z'}, {'type': 's', 'time': '2025-05-14T17:13:33.466Z'}, {'type': 's', 'time': '2025-05-14T17:13:37.017Z'}, {'type': 'l', 'time': '2025-05-14T17:13:42.826Z'}, {'type': 's', 'time': '2025-05-14T17:13:45.409Z'}, {'type': 'l', 'time': '2025-05-14T17:13:48.008Z'}, {'type': 's', 'time': '2025-05-14T17:13:53.160Z'}]",20,7,27,13
36,36,4,B. campestris,1747242869841,2025-05-14T17:14:29.841Z,1747242989841,2025-05-14T17:16:29.841Z,"[{'type': 's', 'time': '2025-05-14T17:14:36.432Z'}, {'type': 's', 'time': '2025-05-14T17:14:41.575Z'}, {'type': 's', 'time': '2025-05-14T17:14:53.641Z'}, {'type': 'l', 'time': '2025-05-14T17:14:57.913Z'}, {'type': 's', 'time': '2025-05-14T17:15:05.822Z'}, {'type': 's', 'time': '2025-05-14T17:15:08.660Z'}, {'type': 's', 'time': '2025-05-14T17:15:14.146Z'}, {'type': 'l', 'time': '2025-05-14T17:15:19.163Z'}, {'type': 's', 'time': '2025-05-14T17:15:21.597Z'}, {'type': 'l', 'time': '2025-05-14T17:15:23.858Z'}, {'type': 's', 'time': '2025-05-14T17:15:39.505Z'}, {'type': 's', 'time': '2025-05-14T17:15:46.821Z'}, {'type': 'l', 'time': '2025-05-14T17:16:05.719Z'}, {'type': 'l', 'time': '2025-05-14T17:16:17.195Z'}]",9,5,14,4
37,37,4,B. pascuorum,1747243237501,2025-05-14T17:20:37.501Z,1747243357501,2025-05-14T17:22:37.501Z,"[{'type': 's', 'time': '2025-05-14T17:20:40.481Z'}, {'type': 's', 'time': '2025-05-14T17:20:44.180Z'}, {'type': 'l', 'time': '2025-05-14T17:20:46.658Z'}, {'type': 's', 'time': '2025-05-14T17:20:52.330Z'}, {'type': 's', 'time': '2025-05-14T17:20:58.397Z'}, {'type': 's', 'time': '2025-05-14T17:21:01.740Z'}, {'type': 's', 'time': '2025-05-14T17:21:08.296Z'}, {'type': 'l', 'time': '2025-05-14T17:21:10.255Z'}, {'type': 's', 'time': '2025-05-14T17:21:11.497Z'}, {'type': 's', 'time': '2025-05-14T17:21:14.787Z'}, {'type': 's', 'time': '2025-05-14T17:21:18.636Z'}, {'type': 'l', 'time': '2025-05-14T17:21:20.898Z'}, {'type': 's', 'time': '2025-05-14T17:21:37.964Z'}, {'type': 's', 'time': '2025-05-14T17:21:44.703Z'}, {'type': 'l', 'time': '2025-05-14T17:21:50.869Z'}, {'type': 'l', 'time': '2025-05-14T17:21:54.404Z'}, {'type': 'l', 'time': '2025-05-14T17:21:59.753Z'}, {'type': 's', 'time': '2025-05-14T17:22:02.286Z'}, {'type': 's', 'time': '2025-05-14T17:22:04.577Z'}, {'type': 's', 'time': '2025-05-14T17:22:14.162Z'}, {'type': 'l', 'time': '2025-05-14T17:22:21.484Z'}, {'type': 's', 'time': '2025-05-14T17:22:26.710Z'}, {'type': 'l', 'time': '2025-05-14T17:22:35.176Z'}]",15,8,23,7
38,38,4,B. hortorum,1747243495645,2025-05-14T17:24:55.645Z,1747243615645,2025-05-14T17:26:55.645Z,"[{'type': 's', 'time': '2025-05-14T17:25:00.553Z'}, {'type': 's', 'time': '2025-05-14T17:25:02.811Z'}, {'type': 's', 'time': '2025-05-14T17:25:06.472Z'}, {'type': 'l', 'time': '2025-05-14T17:25:07.657Z'}, {'type': 's', 'time': '2025-05-14T17:25:09.412Z'}, {'type': 's', 'time': '2025-05-14T17:25:11.956Z'}, {'type': 's', 'time': '2025-05-14T17:25:14.264Z'}, {'type': 's', 'time': '2025-05-14T17:25:22.988Z'}, {'type': 's', 'time': '2025-05-14T17:25:25.196Z'}, {'type': 's', 'time': '2025-05-14T17:25:28.455Z'}, {'type': 's', 'time': '2025-05-14T17:25:31.280Z'}, {'type': 's', 'time': '2025-05-14T17:25:32.747Z'}, {'type': 's', 'time': '2025-05-14T17:25:36.477Z'}, {'type': 'l', 'time': '2025-05-14T17:25:38.380Z'}, {'type': 's', 'time': '2025-05-14T17:25:42.459Z'}, {'type': 's', 'time': '2025-05-14T17:25:46.482Z'}, {'type': 's', 'time': '2025-05-14T17:25:48.405Z'}, {'type': 's', 'time': '2025-05-14T17:25:51.016Z'}, {'type': 's', 'time': '2025-05-14T17:25:56.647Z'}, {'type': 'l', 'time': '2025-05-14T17:26:01.763Z'}, {'type': 's', 'time': '2025-05-14T17:26:03.606Z'}, {'type': 'l', 'time': '2025-05-14T17:26:07.067Z'}, {'type': 'l', 'time': '2025-05-14T17:26:09.827Z'}, {'type': 's', 'time': '2025-05-14T17:26:15.796Z'}, {'type': 's', 'time': '2025-05-14T17:26:20.129Z'}, {'type': 'l', 'time': '2025-05-14T17:26:22.212Z'}, {'type': 's', 'time': '2025-05-14T17:26:25.828Z'}, {'type': 's', 'time': '2025-05-14T17:26:28.970Z'}, {'type': 's', 'time': '2025-05-14T17:26:32.696Z'}, {'type': 'l', 'time': '2025-05-14T17:26:42.362Z'}, {'type': 'l', 'time': '2025-05-14T17:26:46.162Z'}, {'type': 's', 'time': '2025-05-14T17:26:49.261Z'}, {'type': 's', 'time': '2025-05-14T17:26:51.436Z'}]",25,8,33,17
39,39,4,B. bohemicus,1747243667591,2025-05-14T17:27:47.591Z,1747243787591,2025-05-14T17:29:47.591Z,"[{'type': 's', 'time': '2025-05-14T17:27:50.200Z'}, {'type': 'l', 'time': '2025-05-14T17:27:55.005Z'}, {'type': 's', 'time': '2025-05-14T17:28:01.815Z'}, {'type': 's', 'time': '2025-05-14T17:28:04.956Z'}, {'type': 'l', 'time': '2025-05-14T17:28:10.306Z'}, {'type': 's', 'time': '2025-05-14T17:28:22.507Z'}, {'type': 's', 'time': '2025-05-14T17:28:25.983Z'}, {'type': 's', 'time': '2025-05-14T17:28:30.098Z'}, {'type': 'l', 'time': '2025-05-14T17:28:35.156Z'}, {'type': 'l', 'time': '2025-05-14T17:28:38.156Z'}, {'type': 's', 'time': '2025-05-14T17:28:41.696Z'}, {'type': 'l', 'time': '2025-05-14T17:28:46.339Z'}, {'type': 's', 'time': '2025-05-14T17:28:48.764Z'}, {'type': 's', 'time': '2025-05-14T17:28:51.829Z'}, {'type': 's', 'time': '2025-05-14T17:28:54.254Z'}, {'type': 's', 'time': '2025-05-14T17:28:57.064Z'}, {'type': 's', 'time': '2025-05-14T17:29:00.005Z'}, {'type': 's', 'time': '2025-05-14T17:29:04.572Z'}, {'type': 'l', 'time': '2025-05-14T17:29:11.509Z'}, {'type': 'l', 'time': '2025-05-14T17:29:16.697Z'}, {'type': 's', 'time': '2025-05-14T17:29:19.654Z'}, {'type': 's', 'time': '2025-05-14T17:29:27.587Z'}, {'type': 'l', 'time': '2025-05-14T17:29:31.378Z'}, {'type': 'l', 'time': '2025-05-14T17:29:47.020Z'}]",15,9,24,6
40,40,5,B. hortorum,1747329103847,2025-05-15T17:11:43.847Z,1747329223847,2025-05-15T17:13:43.847Z,"[{'type': 's', 'time': '2025-05-15T17:11:45.355Z'}, {'type': 's', 'time': '2025-05-15T17:11:47.485Z'}, {'type': 's', 'time': '2025-05-15T17:11:50.721Z'}, {'type': 's', 'time': '2025-05-15T17:11:52.205Z'}, {'type': 's', 'time': '2025-05-15T17:11:53.837Z'}, {'type': 's', 'time': '2025-05-15T17:11:59.471Z'}, {'type': 's', 'time': '2025-05-15T17:12:02.829Z'}, {'type': 's', 'time': '2025-05-15T17:12:05.893Z'}, {'type': 's', 'time': '2025-05-15T17:12:08.770Z'}, {'type': 's', 'time': '2025-05-15T17:12:12.811Z'}, {'type': 'l', 'time': '2025-05-15T17:12:17.977Z'}, {'type': 's', 'time': '2025-05-15T17:12:19.445Z'}, {'type': 's', 'time': '2025-05-15T17:12:24.778Z'}, {'type': 's', 'time': '2025-05-15T17:12:27.335Z'}, {'type': 's', 'time': '2025-05-15T17:12:29.691Z'}, {'type': 's', 'time': '2025-05-15T17:12:32.783Z'}, {'type': 'l', 'time': '2025-05-15T17:12:38.878Z'}, {'type': 's', 'time': '2025-05-15T17:12:40.633Z'}, {'type': 's', 'time': '2025-05-15T17:12:42.610Z'}, {'type': 's', 'time': '2025-05-15T17:12:45.369Z'}, {'type': 's', 'time': '2025-05-15T17:12:47.910Z'}, {'type': 'l', 'time': '2025-05-15T17:12:50.574Z'}, {'type': 's', 'time': '2025-05-15T17:12:52.669Z'}, {'type': 's', 'time': '2025-05-15T17:12:56.552Z'}, {'type': 'l', 'time': '2025-05-15T17:12:59.935Z'}, {'type': 's', 'time': '2025-05-15T17:13:01.135Z'}, {'type': 's', 'time': '2025-05-15T17:13:03.743Z'}, {'type': 's', 'time': '2025-05-15T17:13:07.399Z'}, {'type': 'l', 'time': '2025-05-15T17:13:12.532Z'}, {'type': 'l', 'time': '2025-05-15T17:13:16.025Z'}, {'type': 'l', 'time': '2025-05-15T17:13:20.393Z'}, {'type': 's', 'time': '2025-05-15T17:13:25.442Z'}, {'type': 's', 'time': '2025-05-15T17:13:28.034Z'}, {'type': 'l', 'time': '2025-05-15T17:13:30.584Z'}, {'type': 's', 'time': '2025-05-15T17:13:32.166Z'}, {'type': 'l', 'time': '2025-05-15T17:13:34.942Z'}, {'type': 'l', 'time': '2025-05-15T17:13:38.949Z'}]",27,10,37,17
41,41,5,B. hortorum,1747329263214,2025-05-15T17:14:23.214Z,1747329383214,2025-05-15T17:16:23.214Z,"[{'type': 'l', 'time': '2025-05-15T17:14:26.980Z'}, {'type': 'l', 'time': '2025-05-15T17:14:34.381Z'}, {'type': 's', 'time': '2025-05-15T17:14:38.488Z'}, {'type': 's', 'time': '2025-05-15T17:14:40.314Z'}, {'type': 's', 'time': '2025-05-15T17:14:42.730Z'}, {'type': 's', 'time': '2025-05-15T17:14:48.188Z'}, {'type': 's', 'time': '2025-05-15T17:14:53.188Z'}, {'type': 'l', 'time': '2025-05-15T17:15:05.971Z'}, {'type': 's', 'time': '2025-05-15T17:15:12.476Z'}, {'type': 's', 'time': '2025-05-15T17:15:16.271Z'}, {'type': 'l', 'time': '2025-05-15T17:15:18.809Z'}, {'type': 's', 'time': '2025-05-15T17:15:20.629Z'}, {'type': 's', 'time': '2025-05-15T17:15:25.437Z'}, {'type': 'l', 'time': '2025-05-15T17:15:28.462Z'}, {'type': 's', 'time': '2025-05-15T17:15:33.684Z'}, {'type': 'l', 'time': '2025-05-15T17:15:35.986Z'}, {'type': 's', 'time': '2025-05-15T17:15:40.119Z'}, {'type': 'l', 'time': '2025-05-15T17:15:42.794Z'}, {'type': 's', 'time': '2025-05-15T17:15:45.341Z'}, {'type': 's', 'time': '2025-05-15T17:15:53.993Z'}, {'type': 's', 'time': '2025-05-15T17:15:59.254Z'}, {'type': 'l', 'time': '2025-05-15T17:16:07.168Z'}, {'type': 'l', 'time': '2025-05-15T17:16:14.151Z'}, {'type': 'l', 'time': '2025-05-15T17:16:19.148Z'}]",14,10,24,4
42,42,5,B. hypnorum,1747329628926,2025-05-15T17:20:28.926Z,1747329748926,2025-05-15T17:22:28.926Z,"[{'type': 's', 'time': '2025-05-15T17:20:44.589Z'}, {'type': 'l', 'time': '2025-05-15T17:20:51.789Z'}, {'type': 's', 'time': '2025-05-15T17:20:53.931Z'}, {'type': 's', 'time': '2025-05-15T17:20:55.794Z'}, {'type': 'l', 'time': '2025-05-15T17:21:01.363Z'}, {'type': 's', 'time': '2025-05-15T17:21:06.136Z'}, {'type': 's', 'time': '2025-05-15T17:21:14.521Z'}, {'type': 'l', 'time': '2025-05-15T17:21:30.829Z'}, {'type': 's', 'time': '2025-05-15T17:21:37.287Z'}, {'type': 'l', 'time': '2025-05-15T17:21:44.552Z'}, {'type': 's', 'time': '2025-05-15T17:21:46.869Z'}, {'type': 's', 'time': '2025-05-15T17:21:54.677Z'}, {'type': 'l', 'time': '2025-05-15T17:22:23.103Z'}, {'type': 's', 'time': '2025-05-15T17:22:27.543Z'}]",9,5,14,4
43,43,5,B. lucorum,1747329798841,2025-05-15T17:23:18.841Z,1747329918841,2025-05-15T17:25:18.841Z,"[{'type': 's', 'time': '2025-05-15T17:23:23.505Z'}, {'type': 's', 'time': '2025-05-15T17:23:26.688Z'}, {'type': 'l', 'time': '2025-05-15T17:23:29.188Z'}, {'type': 'l', 'time': '2025-05-15T17:23:35.537Z'}, {'type': 'l', 'time': '2025-05-15T17:23:38.779Z'}, {'type': 's', 'time': '2025-05-15T17:23:42.050Z'}, {'type': 's', 'time': '2025-05-15T17:23:48.589Z'}, {'type': 's', 'time': '2025-05-15T17:23:55.610Z'}, {'type': 'l', 'time': '2025-05-15T17:23:57.214Z'}, {'type': 'l', 'time': '2025-05-15T17:24:05.003Z'}, {'type': 's', 'time': '2025-05-15T17:24:12.772Z'}, {'type': 's', 'time': '2025-05-15T17:24:14.314Z'}, {'type': 's', 'time': '2025-05-15T17:24:16.564Z'}, {'type': 's', 'time': '2025-05-15T17:24:22.929Z'}, {'type': 's', 'time': '2025-05-15T17:24:29.029Z'}, {'type': 's', 'time': '2025-05-15T17:24:36.346Z'}, {'type': 's', 'time': '2025-05-15T17:24:45.519Z'}, {'type': 'l', 'time': '2025-05-15T17:24:47.567Z'}, {'type': 's', 'time': '2025-05-15T17:24:54.786Z'}, {'type': 'l', 'time': '2025-05-15T17:25:00.589Z'}, {'type': 's', 'time': '2025-05-15T17:25:03.729Z'}, {'type': 's', 'time': '2025-05-15T17:25:10.020Z'}, {'type': 's', 'time': '2025-05-15T17:25:13.086Z'}, {'type': 'l', 'time': '2025-05-15T17:25:15.795Z'}]",16,8,24,8
44,44,5,B. campestris,1747330029911,2025-05-15T17:27:09.911Z,1747330149911,2025-05-15T17:29:09.911Z,"[{'type': 's', 'time': '2025-05-15T17:27:14.885Z'}, {'type': 'l', 'time': '2025-05-15T17:27:23.048Z'}, {'type': 's', 'time': '2025-05-15T17:27:30.268Z'}, {'type': 'l', 'time': '2025-05-15T17:27:32.992Z'}, {'type': 's', 'time': '2025-05-15T17:27:43.266Z'}, {'type': 's', 'time': '2025-05-15T17:27:45.214Z'}, {'type': 'l', 'time': '2025-05-15T17:27:47.699Z'}, {'type': 'l', 'time': '2025-05-15T17:27:49.525Z'}, {'type': 'l', 'time': '2025-05-15T17:27:53.207Z'}, {'type': 's', 'time': '2025-05-15T17:28:00.740Z'}, {'type': 'l', 'time': '2025-05-15T17:28:26.447Z'}, {'type': 's', 'time': '2025-05-15T17:28:30.696Z'}, {'type': 's', 'time': '2025-05-15T17:28:39.147Z'}, {'type': 's', 'time': '2025-05-15T17:28:40.797Z'}, {'type': 'l', 'time': '2025-05-15T17:28:43.901Z'}, {'type': 's', 'time': '2025-05-15T17:28:50.031Z'}, {'type': 's', 'time': '2025-05-15T17:28:57.080Z'}, {'type': 'l', 'time': '2025-05-15T17:29:05.436Z'}]",10,8,18,2
45,45,5,B. pascuorum,1747330245015,2025-05-15T17:30:45.015Z,1747330365015,2025-05-15T17:32:45.015Z,"[{'type': 's', 'time': '2025-05-15T17:30:46.941Z'}, {'type': 'l', 'time': '2025-05-15T17:30:51.356Z'}, {'type': 's', 'time': '2025-05-15T17:31:07.681Z'}, {'type': 'l', 'time': '2025-05-15T17:31:13.214Z'}, {'type': 's', 'time': '2025-05-15T17:31:17.297Z'}, {'type': 's', 'time': '2025-05-15T17:31:21.279Z'}, {'type': 's', 'time': '2025-05-15T17:31:25.513Z'}, {'type': 'l', 'time': '2025-05-15T17:31:30.080Z'}, {'type': 's', 'time': '2025-05-15T17:31:35.721Z'}, {'type': 's', 'time': '2025-05-15T17:31:42.530Z'}, {'type': 's', 'time': '2025-05-15T17:31:45.526Z'}, {'type': 'l', 'time': '2025-05-15T17:31:58.042Z'}, {'type': 's', 'time': '2025-05-15T17:32:07.221Z'}, {'type': 'l', 'time': '2025-05-15T17:32:13.693Z'}, {'type': 'l', 'time': '2025-05-15T17:32:44.227Z'}]",9,6,15,3
46,46,5,B. campestris,1747330456399,2025-05-15T17:34:16.399Z,1747330576399,2025-05-15T17:36:16.399Z,"[{'type': 's', 'time': '2025-05-15T17:34:22.346Z'}, {'type': 'l', 'time': '2025-05-15T17:34:24.581Z'}, {'type': 's', 'time': '2025-05-15T17:34:29.356Z'}, {'type': 'l', 'time': '2025-05-15T17:34:33.516Z'}, {'type': 's', 'time': '2025-05-15T17:34:40.111Z'}, {'type': 's', 'time': '2025-05-15T17:34:48.002Z'}, {'type': 's', 'time': '2025-05-15T17:34:50.613Z'}, {'type': 'l', 'time': '2025-05-15T17:35:08.971Z'}, {'type': 'l', 'time': '2025-05-15T17:35:23.820Z'}, {'type': 's', 'time': '2025-05-15T17:35:37.277Z'}, {'type': 's', 'time': '2025-05-15T17:35:39.956Z'}, {'type': 's', 'time': '2025-05-15T17:35:52.126Z'}, {'type': 'l', 'time': '2025-05-15T17:36:04.576Z'}, {'type': 'l', 'time': '2025-05-15T17:36:11.768Z'}]",8,6,14,2
47,47,5,B. pratorum,1747330652664,2025-05-15T17:37:32.664Z,1747330772664,2025-05-15T17:39:32.664Z,"[{'type': 'l', 'time': '2025-05-15T17:37:46.129Z'}, {'type': 's', 'time': '2025-05-15T17:37:47.988Z'}, {'type': 'l', 'time': '2025-05-15T17:37:56.171Z'}, {'type': 's', 'time': '2025-05-15T17:37:59.037Z'}, {'type': 's', 'time': '2025-05-15T17:38:07.487Z'}, {'type': 'l', 'time': '2025-05-15T17:38:19.877Z'}, {'type': 's', 'time': '2025-05-15T17:38:23.149Z'}, {'type': 'l', 'time': '2025-05-15T17:38:31.817Z'}, {'type': 's', 'time': '2025-05-15T17:38:40.402Z'}, {'type': 's', 'time': '2025-05-15T17:38:42.619Z'}, {'type': 's', 'time': '2025-05-15T17:38:45.117Z'}, {'type': 'l', 'time': '2025-05-15T17:38:49.669Z'}, {'type': 's', 'time': '2025-05-15T17:38:52.675Z'}, {'type': 'l', 'time': '2025-05-15T17:39:31.082Z'}]",8,6,14,2
48,48,5,B. campestris,1747330870238,2025-05-15T17:41:10.238Z,1747330990238,2025-05-15T17:43:10.238Z,"[{'type': 's', 'time': '2025-05-15T17:41:16.811Z'}, {'type': 's', 'time': '2025-05-15T17:41:28.650Z'}, {'type': 'l', 'time': '2025-05-15T17:41:32.478Z'}, {'type': 's', 'time': '2025-05-15T17:41:49.677Z'}, {'type': 'l', 'time': '2025-05-15T17:41:51.860Z'}, {'type': 'l', 'time': '2025-05-15T17:41:57.759Z'}, {'type': 's', 'time': '2025-05-15T17:42:10.875Z'}, {'type': 'l', 'time': '2025-05-15T17:42:22.477Z'}, {'type': 's', 'time': '2025-05-15T17:42:25.368Z'}, {'type': 's', 'time': '2025-05-15T17:42:28.589Z'}, {'type': 'l', 'time': '2025-05-15T17:42:36.963Z'}, {'type': 's', 'time': '2025-05-15T17:42:43.304Z'}, {'type': 's', 'time': '2025-05-15T17:42:51.713Z'}, {'type': 'l', 'time': '2025-05-15T17:42:56.857Z'}, {'type': 'l', 'time': '2025-05-15T17:43:01.305Z'}]",8,7,15,1
49,49,5,B. hortorum,1747331078826,2025-05-15T17:44:38.826Z,1747331198826,2025-05-15T17:46:38.826Z,"[{'type': 'l', 'time': '2025-05-15T17:44:46.627Z'}, {'type': 's', 'time': '2025-05-15T17:44:47.726Z'}, {'type': 'l', 'time': '2025-05-15T17:44:50.873Z'}, {'type': 's', 'time': '2025-05-15T17:44:53.168Z'}, {'type': 'l', 'time': '2025-05-15T17:44:59.514Z'}, {'type': 's', 'time': '2025-05-15T17:45:01.600Z'}, {'type': 'l', 'time': '2025-05-15T17:45:06.201Z'}, {'type': 's', 'time': '2025-05-15T17:45:10.924Z'}, {'type': 'l', 'time': '2025-05-15T17:45:18.900Z'}, {'type': 's', 'time': '2025-05-15T17:45:19.533Z'}, {'type': 's', 'time': '2025-05-15T17:45:21.257Z'}, {'type': 's', 'time': '2025-05-15T17:45:23.571Z'}, {'type': 'l', 'time': '2025-05-15T17:45:28.522Z'}, {'type': 'l', 'time': '2025-05-15T17:45:34.855Z'}, {'type': 's', 'time': '2025-05-15T17:45:35.816Z'}, {'type': 's', 'time': '2025-05-15T17:45:38.225Z'}, {'type': 's', 'time': '2025-05-15T17:45:41.765Z'}, {'type': 's', 'time': '2025-05-15T17:45:44.316Z'}, {'type': 's', 'time': '2025-05-15T17:45:46.199Z'}, {'type': 'l', 'time': '2025-05-15T17:45:50.254Z'}, {'type': 'l', 'time': '2025-05-15T17:46:12.846Z'}, {'type': 's', 'time': '2025-05-15T17:46:16.013Z'}, {'type': 's', 'time': '2025-05-15T17:46:18.253Z'}, {'type': 'l', 'time': '2025-05-15T17:46:22.247Z'}, {'type': 's', 'time': '2025-05-15T17:46:25.545Z'}, {'type': 's', 'time': '2025-05-15T17:46:27.488Z'}, {'type': 's', 'time': '2025-05-15T17:46:34.346Z'}]",17,10,27,7
50,50,6,B. hortorum,1747417441454,2025-05-16T17:44:01.454Z,1747417561454,2025-05-16T17:46:01.454Z,"[{'type': 's', 'time': '2025-05-16T17:44:05.033Z'}, {'type': 's', 'time': '2025-05-16T17:44:10.419Z'}, {'type': 's', 'time': '2025-05-16T17:44:15.859Z'}, {'type': 'l', 'time': '2025-05-16T17:44:22.346Z'}, {'type': 's', 'time': '2025-05-16T17:44:30.067Z'}, {'type': 's', 'time': '2025-05-16T17:44:40.925Z'}, {'type': 'l', 'time': '2025-05-16T17:45:07.109Z'}, {'type': 'l', 'time': '2025-05-16T17:45:11.101Z'}, {'type': 'l', 'time': '2025-05-16T17:45:18.877Z'}, {'type': 'l', 'time': '2025-05-16T17:45:24.790Z'}, {'type': 's', 'time': '2025-05-16T17:45:30.593Z'}, {'type': 's', 'time': '2025-05-16T17:45:36.247Z'}, {'type': 'l', 'time': '2025-05-16T17:45:44.074Z'}, {'type': 's', 'time': '2025-05-16T17:45:52.131Z'}]",8,6,14,2
51,51,6,B. campestris,1747417699903,2025-05-16T17:48:19.903Z,1747417819903,2025-05-16T17:50:19.903Z,"[{'type': 'l', 'time': '2025-05-16T17:48:26.161Z'}, {'type': 's', 'time': '2025-05-16T17:48:36.475Z'}, {'type': 's', 'time': '2025-05-16T17:48:42.926Z'}, {'type': 's', 'time': '2025-05-16T17:48:47.984Z'}, {'type': 's', 'time': '2025-05-16T17:48:56.368Z'}, {'type': 's', 'time': '2025-05-16T17:49:07.049Z'}, {'type': 'l', 'time': '2025-05-16T17:49:16.274Z'}, {'type': 's', 'time': '2025-05-16T17:49:20.524Z'}, {'type': 's', 'time': '2025-05-16T17:49:25.266Z'}, {'type': 's', 'time': '2025-05-16T17:49:27.506Z'}, {'type': 'l', 'time': '2025-05-16T17:49:32.873Z'}, {'type': 'l', 'time': '2025-05-16T17:49:48.123Z'}]",8,4,12,4
52,52,6,B. lucorum,1747417925335,2025-05-16T17:52:05.335Z,1747418045335,2025-05-16T17:54:05.335Z,"[{'type': 'l', 'time': '2025-05-16T17:52:10.403Z'}, {'type': 's', 'time': '2025-05-16T17:52:12.342Z'}, {'type': 'l', 'time': '2025-05-16T17:52:14.365Z'}, {'type': 'l', 'time': '2025-05-16T17:52:21.133Z'}, {'type': 'l', 'time': '2025-05-16T17:52:24.793Z'}, {'type': 's', 'time': '2025-05-16T17:52:27.308Z'}, {'type': 'l', 'time': '2025-05-16T17:52:30.381Z'}, {'type': 's', 'time': '2025-05-16T17:52:32.126Z'}, {'type': 's', 'time': '2025-05-16T17:52:34.128Z'}, {'type': 'l', 'time': '2025-05-16T17:52:36.693Z'}, {'type': 's', 'time': '2025-05-16T17:52:40.150Z'}, {'type': 'l', 'time': '2025-05-16T17:52:42.884Z'}, {'type': 'l', 'time': '2025-05-16T17:52:45.965Z'}, {'type': 's', 'time': '2025-05-16T17:52:46.967Z'}, {'type': 's', 'time': '2025-05-16T17:52:48.989Z'}, {'type': 's', 'time': '2025-05-16T17:52:51.239Z'}, {'type': 's', 'time': '2025-05-16T17:52:54.391Z'}, {'type': 's', 'time': '2025-05-16T17:52:57.166Z'}, {'type': 's', 'time': '2025-05-16T17:53:00.125Z'}, {'type': 'l', 'time': '2025-05-16T17:53:09.410Z'}, {'type': 'l', 'time': '2025-05-16T17:53:12.456Z'}, {'type': 's', 'time': '2025-05-16T17:53:14.815Z'}, {'type': 'l', 'time': '2025-05-16T17:53:19.991Z'}, {'type': 'l', 'time': '2025-05-16T17:53:22.040Z'}, {'type': 'l', 'time': '2025-05-16T17:53:24.891Z'}, {'type': 's', 'time': '2025-05-16T17:53:26.723Z'}, {'type': 's', 'time': '2025-05-16T17:53:29.931Z'}, {'type': 's', 'time': '2025-05-16T17:53:39.101Z'}, {'type': 's', 'time': '2025-05-16T17:53:44.198Z'}, {'type': 's', 'time': '2025-05-16T17:53:48.139Z'}, {'type': 's', 'time': '2025-05-16T17:53:55.881Z'}, {'type': 's', 'time': '2025-05-16T17:54:01.123Z'}, {'type': 'l', 'time': '2025-05-16T17:54:04.847Z'}]",19,14,33,5
53,53,6,B. campestris,1747418116113,2025-05-16T17:55:16.113Z,1747418236113,2025-05-16T17:57:16.113Z,"[{'type': 's', 'time': '2025-05-16T17:55:18.697Z'}, {'type': 's', 'time': '2025-05-16T17:55:24.947Z'}, {'type': 's', 'time': '2025-05-16T17:55:27.927Z'}, {'type': 's', 'time': '2025-05-16T17:55:31.449Z'}, {'type': 'l', 'time': '2025-05-16T17:55:36.503Z'}, {'type': 's', 'time': '2025-05-16T17:55:38.453Z'}, {'type': 'l', 'time': '2025-05-16T17:55:43.320Z'}, {'type': 's', 'time': '2025-05-16T17:55:48.319Z'}, {'type': 's', 'time': '2025-05-16T17:55:53.182Z'}, {'type': 's', 'time': '2025-05-16T17:55:56.243Z'}, {'type': 'l', 'time': '2025-05-16T17:56:01.793Z'}, {'type': 's', 'time': '2025-05-16T17:56:06.118Z'}, {'type': 'l', 'time': '2025-05-16T17:56:09.734Z'}, {'type': 's', 'time': '2025-05-16T17:56:18.842Z'}, {'type': 'l', 'time': '2025-05-16T17:56:26.743Z'}, {'type': 's', 'time': '2025-05-16T17:56:38.968Z'}, {'type': 's', 'time': '2025-05-16T17:56:42.142Z'}, {'type': 's', 'time': '2025-05-16T17:56:46.617Z'}, {'type': 'l', 'time': '2025-05-16T17:56:53.050Z'}, {'type': 's', 'time': '2025-05-16T17:57:00.608Z'}, {'type': 'l', 'time': '2025-05-16T17:57:15.807Z'}]",14,7,21,7
54,54,6,B. campestris,1747418320829,2025-05-16T17:58:40.829Z,1747418440829,2025-05-16T18:00:40.829Z,"[{'type': 's', 'time': '2025-05-16T17:58:42.780Z'}, {'type': 'l', 'time': '2025-05-16T17:58:47.011Z'}, {'type': 's', 'time': '2025-05-16T17:58:49.754Z'}, {'type': 's', 'time': '2025-05-16T17:58:52.762Z'}, {'type': 's', 'time': '2025-05-16T17:58:57.123Z'}, {'type': 's', 'time': '2025-05-16T17:59:03.445Z'}, {'type': 's', 'time': '2025-05-16T17:59:08.517Z'}, {'type': 's', 'time': '2025-05-16T17:59:15.278Z'}, {'type': 's', 'time': '2025-05-16T17:59:28.352Z'}, {'type': 'l', 'time': '2025-05-16T17:59:31.619Z'}, {'type': 's', 'time': '2025-05-16T17:59:40.277Z'}, {'type': 's', 'time': '2025-05-16T17:59:43.336Z'}, {'type': 's', 'time': '2025-05-16T17:59:50.517Z'}, {'type': 'l', 'time': '2025-05-16T18:00:05.068Z'}, {'type': 'l', 'time': '2025-05-16T18:00:12.793Z'}, {'type': 's', 'time': '2025-05-16T18:00:25.315Z'}]",12,4,16,8
55,55,6,B. campestris,1747418501081,2025-05-16T18:01:41.081Z,1747418621081,2025-05-16T18:03:41.081Z,"[{'type': 'l', 'time': '2025-05-16T18:01:48.760Z'}, {'type': 's', 'time': '2025-05-16T18:01:51.851Z'}, {'type': 'l', 'time': '2025-05-16T18:01:59.642Z'}, {'type': 's', 'time': '2025-05-16T18:02:06.970Z'}, {'type': 's', 'time': '2025-05-16T18:02:12.437Z'}, {'type': 's', 'time': '2025-05-16T18:02:15.007Z'}, {'type': 'l', 'time': '2025-05-16T18:02:25.139Z'}, {'type': 'l', 'time': '2025-05-16T18:02:33.930Z'}, {'type': 's', 'time': '2025-05-16T18:02:39.755Z'}, {'type': 's', 'time': '2025-05-16T18:02:44.517Z'}, {'type': 's', 'time': '2025-05-16T18:02:48.528Z'}, {'type': 's', 'time': '2025-05-16T18:02:52.220Z'}, {'type': 's', 'time': '2025-05-16T18:02:55.568Z'}, {'type': 'l', 'time': '2025-05-16T18:03:00.527Z'}, {'type': 's', 'time': '2025-05-16T18:03:03.929Z'}, {'type': 's', 'time': '2025-05-16T18:03:08.435Z'}, {'type': 'l', 'time': '2025-05-16T18:03:14.354Z'}, {'type': 's', 'time': '2025-05-16T18:03:17.159Z'}, {'type': 'l', 'time': '2025-05-16T18:03:23.945Z'}, {'type': 'l', 'time': '2025-05-16T18:03:27.237Z'}, {'type': 'l', 'time': '2025-05-16T18:03:39.037Z'}]",12,9,21,3
56,56,6,B. campestris,1747418700021,2025-05-16T18:05:00.022Z,1747418820021,2025-05-16T18:07:00.021Z,"[{'type': 's', 'time': '2025-05-16T18:05:02.683Z'}, {'type': 'l', 'time': '2025-05-16T18:05:06.380Z'}, {'type': 's', 'time': '2025-05-16T18:05:09.291Z'}, {'type': 'l', 'time': '2025-05-16T18:05:12.429Z'}, {'type': 's', 'time': '2025-05-16T18:05:17.022Z'}, {'type': 'l', 'time': '2025-05-16T18:05:22.935Z'}, {'type': 's', 'time': '2025-05-16T18:05:28.340Z'}, {'type': 'l', 'time': '2025-05-16T18:05:33.449Z'}, {'type': 's', 'time': '2025-05-16T18:05:40.450Z'}, {'type': 'l', 'time': '2025-05-16T18:05:47.746Z'}, {'type': 's', 'time': '2025-05-16T18:05:52.414Z'}, {'type': 's', 'time': '2025-05-16T18:05:57.665Z'}, {'type': 'l', 'time': '2025-05-16T18:05:59.972Z'}, {'type': 's', 'time': '2025-05-16T18:06:03.421Z'}, {'type': 's', 'time': '2025-05-16T18:06:10.673Z'}, {'type': 's', 'time': '2025-05-16T18:06:22.438Z'}, {'type': 's', 'time': '2025-05-16T18:06:26.037Z'}, {'type': 's', 'time': '2025-05-16T18:06:28.555Z'}, {'type': 's', 'time': '2025-05-16T18:06:32.205Z'}, {'type': 'l', 'time': '2025-05-16T18:06:35.443Z'}, {'type': 's', 'time': '2025-05-16T18:06:41.111Z'}, {'type': 's', 'time': '2025-05-16T18:06:43.172Z'}, {'type': 's', 'time': '2025-05-16T18:06:48.180Z'}, {'type': 'l', 'time': '2025-05-16T18:06:51.196Z'}, {'type': 'l', 'time': '2025-05-16T18:06:53.219Z'}, {'type': 'l', 'time': '2025-05-16T18:06:56.638Z'}, {'type': 'l', 'time': '2025-05-16T18:06:59.204Z'}]",16,11,27,5
57,57,6,B. campestris,1747418940128,2025-05-16T18:09:00.128Z,1747419060128,2025-05-16T18:11:00.128Z,"[{'type': 's', 'time': '2025-05-16T18:09:04.515Z'}, {'type': 's', 'time': '2025-05-16T18:09:12.777Z'}, {'type': 's', 'time': '2025-05-16T18:09:15.734Z'}, {'type': 's', 'time': '2025-05-16T18:09:18.678Z'}, {'type': 's', 'time': '2025-05-16T18:09:26.057Z'}, {'type': 's', 'time': '2025-05-16T18:09:47.240Z'}, {'type': 's', 'time': '2025-05-16T18:09:51.181Z'}, {'type': 'l', 'time': '2025-05-16T18:09:52.954Z'}, {'type': 'l', 'time': '2025-05-16T18:10:01.064Z'}, {'type': 's', 'time': '2025-05-16T18:10:04.174Z'}, {'type': 's', 'time': '2025-05-16T18:10:08.120Z'}, {'type': 'l', 'time': '2025-05-16T18:10:11.322Z'}, {'type': 's', 'time': '2025-05-16T18:10:16.355Z'}, {'type': 'l', 'time': '2025-05-16T18:10:19.246Z'}, {'type': 's', 'time': '2025-05-16T18:10:22.954Z'}, {'type': 's', 'time': '2025-05-16T18:10:24.932Z'}, {'type': 's', 'time': '2025-05-16T18:10:28.412Z'}, {'type': 'l', 'time': '2025-05-16T18:10:35.185Z'}, {'type': 'l', 'time': '2025-05-16T18:10:42.809Z'}, {'type': 's', 'time': '2025-05-16T18:10:48.328Z'}, {'type': 's', 'time': '2025-05-16T18:10:50.045Z'}]",15,6,21,9
58,58,6,B. lucorum,1747419227155,2025-05-16T18:13:47.155Z,1747419347155,2025-05-16T18:15:47.155Z,"[{'type': 's', 'time': '2025-05-16T18:13:53.600Z'}, {'type': 's', 'time': '2025-05-16T18:13:55.424Z'}, {'type': 's', 'time': '2025-05-16T18:13:58.611Z'}, {'type': 'l', 'time': '2025-05-16T18:14:01.963Z'}, {'type': 'l', 'time': '2025-05-16T18:14:05.242Z'}, {'type': 'l', 'time': '2025-05-16T18:14:09.889Z'}, {'type': 'l', 'time': '2025-05-16T18:14:13.044Z'}, {'type': 's', 'time': '2025-05-16T18:14:14.396Z'}, {'type': 's', 'time': '2025-05-16T18:14:16.529Z'}, {'type': 's', 'time': '2025-05-16T18:14:18.538Z'}, {'type': 's', 'time': '2025-05-16T18:14:21.464Z'}, {'type': 's', 'time': '2025-05-16T18:14:24.662Z'}, {'type': 'l', 'time': '2025-05-16T18:14:26.861Z'}, {'type': 'l', 'time': '2025-05-16T18:14:30.347Z'}, {'type': 's', 'time': '2025-05-16T18:14:33.549Z'}, {'type': 's', 'time': '2025-05-16T18:14:35.230Z'}, {'type': 'l', 'time': '2025-05-16T18:14:38.718Z'}, {'type': 's', 'time': '2025-05-16T18:14:40.620Z'}, {'type': 's', 'time': '2025-05-16T18:14:44.491Z'}, {'type': 'l', 'time': '2025-05-16T18:14:48.737Z'}, {'type': 'l', 'time': '2025-05-16T18:14:53.089Z'}, {'type': 'l', 'time': '2025-05-16T18:14:56.987Z'}, {'type': 'l', 'time': '2025-05-16T18:14:58.336Z'}, {'type': 's', 'time': '2025-05-16T18:15:00.896Z'}, {'type': 's', 'time': '2025-05-16T18:15:03.885Z'}, {'type': 'l', 'time': '2025-05-16T18:15:12.178Z'}, {'type': 'l', 'time': '2025-05-16T18:15:18.061Z'}, {'type': 's', 'time': '2025-05-16T18:15:23.430Z'}, {'type': 's', 'time': '2025-05-16T18:15:26.616Z'}, {'type': 's', 'time': '2025-05-16T18:15:29.067Z'}, {'type': 's', 'time': '2025-05-16T18:15:31.658Z'}, {'type': 'l', 'time': '2025-05-16T18:15:37.502Z'}, {'type': 's', 'time': '2025-05-16T18:15:39.477Z'}, {'type': 's', 'time': '2025-05-16T18:15:41.735Z'}, {'type': 's', 'time': '2025-05-16T18:15:44.748Z'}]",21,14,35,7
59,59,6,B. campestris,1747419446158,2025-05-16T18:17:26.159Z,1747419566158,2025-05-16T18:19:26.158Z,"[{'type': 's', 'time': '2025-05-16T18:17:31.073Z'}, {'type': 's', 'time': '2025-05-16T18:17:34.848Z'}, {'type': 'l', 'time': '2025-05-16T18:17:40.344Z'}, {'type': 'l', 'time': '2025-05-16T18:17:49.573Z'}, {'type': 's', 'time': '2025-05-16T18:18:31.261Z'}, {'type': 's', 'time': '2025-05-16T18:18:34.975Z'}, {'type': 's', 'time': '2025-05-16T18:18:37.984Z'}, {'type': 's', 'time': '2025-05-16T18:18:43.761Z'}, {'type': 's', 'time': '2025-05-16T18:18:49.161Z'}, {'type': 'l', 'time': '2025-05-16T18:18:55.661Z'}, {'type': 'l', 'time': '2025-05-16T18:18:58.520Z'}, {'type': 's', 'time': '2025-05-16T18:19:07.375Z'}, {'type': 's', 'time': '2025-05-16T18:19:13.527Z'}, {'type': 'l', 'time': '2025-05-16T18:19:19.659Z'}]",9,5,14,4
60,60,7,B. lucorum,1747501559075,2025-05-17T17:05:59.075Z,1747501679075,2025-05-17T17:07:59.075Z,"[{'type': 's', 'time': '2025-05-17T17:06:04.115Z'}, {'type': 's', 'time': '2025-05-17T17:06:07.289Z'}, {'type': 's', 'time': '2025-05-17T17:06:17.321Z'}, {'type': 's', 'time': '2025-05-17T17:06:25.697Z'}, {'type': 's', 'time': '2025-05-17T17:06:28.848Z'}, {'type': 's', 'time': '2025-05-17T17:06:31.144Z'}, {'type': 'l', 'time': '2025-05-17T17:06:32.655Z'}, {'type': 'l', 'time': '2025-05-17T17:06:38.455Z'}, {'type': 'l', 'time': '2025-05-17T17:06:43.952Z'}, {'type': 's', 'time': '2025-05-17T17:06:46.972Z'}, {'type': 's', 'time': '2025-05-17T17:06:48.240Z'}, {'type': 's', 'time': '2025-05-17T17:06:52.222Z'}, {'type': 's', 'time': '2025-05-17T17:06:57.004Z'}, {'type': 's', 'time': '2025-05-17T17:07:00.630Z'}, {'type': 'l', 'time': '2025-05-17T17:07:05.012Z'}, {'type': 's', 'time': '2025-05-17T17:07:07.252Z'}, {'type': 's', 'time': '2025-05-17T17:07:11.272Z'}, {'type': 's', 'time': '2025-05-17T17:07:15.988Z'}, {'type': 's', 'time': '2025-05-17T17:07:22.514Z'}, {'type': 's', 'time': '2025-05-17T17:07:30.642Z'}, {'type': 'l', 'time': '2025-05-17T17:07:35.927Z'}, {'type': 'l', 'time': '2025-05-17T17:07:56.568Z'}]",16,6,22,10
61,61,7,B. pratorum,1747501749059,2025-05-17T17:09:09.059Z,1747501869059,2025-05-17T17:11:09.059Z,"[{'type': 's', 'time': '2025-05-17T17:09:12.733Z'}, {'type': 'l', 'time': '2025-05-17T17:09:20.198Z'}, {'type': 's', 'time': '2025-05-17T17:09:23.630Z'}, {'type': 's', 'time': '2025-05-17T17:09:27.157Z'}, {'type': 's', 'time': '2025-05-17T17:09:32.214Z'}, {'type': 's', 'time': '2025-05-17T17:09:37.723Z'}, {'type': 'l', 'time': '2025-05-17T17:09:42.230Z'}, {'type': 's', 'time': '2025-05-17T17:09:46.111Z'}, {'type': 's', 'time': '2025-05-17T17:09:51.472Z'}, {'type': 's', 'time': '2025-05-17T17:09:56.564Z'}, {'type': 's', 'time': '2025-05-17T17:10:05.385Z'}, {'type': 'l', 'time': '2025-05-17T17:10:14.009Z'}, {'type': 's', 'time': '2025-05-17T17:10:17.580Z'}, {'type': 's', 'time': '2025-05-17T17:10:22.855Z'}, {'type': 's', 'time': '2025-05-17T17:10:25.921Z'}, {'type': 'l', 'time': '2025-05-17T17:10:30.662Z'}, {'type': 's', 'time': '2025-05-17T17:10:33.244Z'}, {'type': 'l', 'time': '2025-05-17T17:10:38.862Z'}, {'type': 's', 'time': '2025-05-17T17:10:43.945Z'}, {'type': 'l', 'time': '2025-05-17T17:10:51.029Z'}, {'type': 's', 'time': '2025-05-17T17:10:53.370Z'}, {'type': 'l', 'time': '2025-05-17T17:10:59.678Z'}, {'type': 's', 'time': '2025-05-17T17:11:02.727Z'}, {'type': 's', 'time': '2025-05-17T17:11:06.385Z'}]",17,7,24,10
62,62,7,B. campestris,1747502181281,2025-05-17T17:16:21.281Z,1747502301281,2025-05-17T17:18:21.281Z,"[{'type': 'l', 'time': '2025-05-17T17:16:29.194Z'}, {'type': 's', 'time': '2025-05-17T17:16:31.644Z'}, {'type': 's', 'time': '2025-05-17T17:16:33.600Z'}, {'type': 'l', 'time': '2025-05-17T17:16:37.264Z'}, {'type': 's', 'time': '2025-05-17T17:16:38.683Z'}, {'type': 'l', 'time': '2025-05-17T17:16:42.600Z'}, {'type': 's', 'time': '2025-05-17T17:16:46.286Z'}, {'type': 'l', 'time': '2025-05-17T17:16:50.009Z'}, {'type': 'l', 'time': '2025-05-17T17:16:54.894Z'}, {'type': 'l', 'time': '2025-05-17T17:17:00.391Z'}, {'type': 's', 'time': '2025-05-17T17:17:00.926Z'}, {'type': 's', 'time': '2025-05-17T17:17:10.942Z'}, {'type': 'l', 'time': '2025-05-17T17:17:20.942Z'}, {'type': 'l', 'time': '2025-05-17T17:17:23.309Z'}, {'type': 's', 'time': '2025-05-17T17:17:25.651Z'}, {'type': 's', 'time': '2025-05-17T17:17:29.222Z'}, {'type': 's', 'time': '2025-05-17T17:17:35.533Z'}, {'type': 's', 'time': '2025-05-17T17:17:40.816Z'}, {'type': 's', 'time': '2025-05-17T17:17:46.842Z'}, {'type': 'l', 'time': '2025-05-17T17:17:48.722Z'}, {'type': 'l', 'time': '2025-05-17T17:17:55.272Z'}, {'type': 's', 'time': '2025-05-17T17:18:00.416Z'}, {'type': 's', 'time': '2025-05-17T17:18:04.957Z'}, {'type': 's', 'time': '2025-05-17T17:18:08.830Z'}, {'type': 'l', 'time': '2025-05-17T17:18:11.475Z'}, {'type': 's', 'time': '2025-05-17T17:18:17.815Z'}]",15,11,26,4
63,63,7,B. lucorum,1747502395578,2025-05-17T17:19:55.578Z,1747502515578,2025-05-17T17:21:55.578Z,"[{'type': 's', 'time': '2025-05-17T17:19:59.344Z'}, {'type': 'l', 'time': '2025-05-17T17:20:04.501Z'}, {'type': 's', 'time': '2025-05-17T17:20:08.947Z'}, {'type': 's', 'time': '2025-05-17T17:20:12.450Z'}, {'type': 's', 'time': '2025-05-17T17:20:16.557Z'}, {'type': 'l', 'time': '2025-05-17T17:20:20.025Z'}, {'type': 'l', 'time': '2025-05-17T17:20:23.693Z'}, {'type': 's', 'time': '2025-05-17T17:20:27.092Z'}, {'type': 's', 'time': '2025-05-17T17:20:30.689Z'}, {'type': 'l', 'time': '2025-05-17T17:20:33.900Z'}, {'type': 'l', 'time': '2025-05-17T17:20:36.667Z'}, {'type': 's', 'time': '2025-05-17T17:20:41.022Z'}, {'type': 's', 'time': '2025-05-17T17:20:44.417Z'}, {'type': 's', 'time': '2025-05-17T17:20:46.415Z'}, {'type': 's', 'time': '2025-05-17T17:20:48.698Z'}, {'type': 'l', 'time': '2025-05-17T17:20:51.630Z'}, {'type': 's', 'time': '2025-05-17T17:20:58.354Z'}, {'type': 's', 'time': '2025-05-17T17:21:01.655Z'}, {'type': 'l', 'time': '2025-05-17T17:21:07.932Z'}, {'type': 's', 'time': '2025-05-17T17:21:10.482Z'}, {'type': 's', 'time': '2025-05-17T17:21:12.346Z'}, {'type': 's', 'time': '2025-05-17T17:21:15.374Z'}, {'type': 's', 'time': '2025-05-17T17:21:21.372Z'}, {'type': 's', 'time': '2025-05-17T17:21:24.183Z'}, {'type': 's', 'time': '2025-05-17T17:21:26.272Z'}, {'type': 's', 'time': '2025-05-17T17:21:28.247Z'}, {'type': 's', 'time': '2025-05-17T17:21:32.389Z'}, {'type': 's', 'time': '2025-05-17T17:21:37.657Z'}, {'type': 'l', 'time': '2025-05-17T17:21:49.164Z'}]",21,8,29,13
64,64,7,B. lucorum,1747502637983,2025-05-17T17:23:57.983Z,1747502757983,2025-05-17T17:25:57.983Z,"[{'type': 'l', 'time': '2025-05-17T17:25:29.752Z'}, {'type': 's', 'time': '2025-05-17T17:25:36.188Z'}, {'type': 's', 'time': '2025-05-17T17:25:39.770Z'}, {'type': 's', 'time': '2025-05-17T17:25:48.589Z'}, {'type': 'l', 'time': '2025-05-17T17:25:57.556Z'}]",3,2,5,1
65,65,7,B. lucorum,1747502808302,2025-05-17T17:26:48.302Z,1747502928302,2025-05-17T17:28:48.302Z,"[{'type': 's', 'time': '2025-05-17T17:26:52.509Z'}, {'type': 'l', 'time': '2025-05-17T17:26:58.727Z'}, {'type': 's', 'time': '2025-05-17T17:27:00.657Z'}, {'type': 's', 'time': '2025-05-17T17:27:04.895Z'}, {'type': 's', 'time': '2025-05-17T17:27:07.829Z'}, {'type': 's', 'time': '2025-05-17T17:27:10.435Z'}, {'type': 's', 'time': '2025-05-17T17:27:18.492Z'}, {'type': 's', 'time': '2025-05-17T17:27:26.233Z'}, {'type': 's', 'time': '2025-05-17T17:27:29.224Z'}, {'type': 'l', 'time': '2025-05-17T17:27:33.692Z'}, {'type': 'l', 'time': '2025-05-17T17:27:38.064Z'}, {'type': 's', 'time': '2025-05-17T17:27:39.930Z'}, {'type': 's', 'time': '2025-05-17T17:27:44.470Z'}, {'type': 's', 'time': '2025-05-17T17:27:46.235Z'}, {'type': 's', 'time': '2025-05-17T17:27:49.241Z'}, {'type': 'l', 'time': '2025-05-17T17:27:52.614Z'}, {'type': 's', 'time': '2025-05-17T17:27:55.078Z'}, {'type': 's', 'time': '2025-05-17T17:27:57.738Z'}, {'type': 's', 'time': '2025-05-17T17:27:59.737Z'}, {'type': 's', 'time': '2025-05-17T17:28:02.098Z'}, {'type': 's', 'time': '2025-05-17T17:28:04.290Z'}, {'type': 'l', 'time': '2025-05-17T17:28:08.395Z'}, {'type': 's', 'time': '2025-05-17T17:28:10.390Z'}, {'type': 's', 'time': '2025-05-17T17:28:14.748Z'}, {'type': 'l', 'time': '2025-05-17T17:28:18.273Z'}, {'type': 's', 'time': '2025-05-17T17:28:29.081Z'}, {'type': 's', 'time': '2025-05-17T17:28:42.904Z'}]",21,6,27,15
66,66,7,B. pascuorum,1747502965229,2025-05-17T17:29:25.229Z,1747503085229,2025-05-17T17:31:25.229Z,"[{'type': 'l', 'time': '2025-05-17T17:29:30.493Z'}, {'type': 's', 'time': '2025-05-17T17:29:33.896Z'}, {'type': 's', 'time': '2025-05-17T17:29:39.637Z'}, {'type': 's', 'time': '2025-05-17T17:29:44.319Z'}, {'type': 'l', 'time': '2025-05-17T17:29:49.279Z'}, {'type': 'l', 'time': '2025-05-17T17:30:01.111Z'}, {'type': 's', 'time': '2025-05-17T17:30:04.744Z'}, {'type': 's', 'time': '2025-05-17T17:30:07.318Z'}, {'type': 'l', 'time': '2025-05-17T17:30:09.101Z'}, {'type': 'l', 'time': '2025-05-17T17:30:14.676Z'}, {'type': 'l', 'time': '2025-05-17T17:30:24.393Z'}, {'type': 's', 'time': '2025-05-17T17:30:27.234Z'}, {'type': 'l', 'time': '2025-05-17T17:30:40.181Z'}, {'type': 'l', 'time': '2025-05-17T17:30:46.032Z'}, {'type': 's', 'time': '2025-05-17T17:30:48.450Z'}, {'type': 'l', 'time': '2025-05-17T17:30:56.975Z'}, {'type': 's', 'time': '2025-05-17T17:31:07.101Z'}, {'type': 's', 'time': '2025-05-17T17:31:09.433Z'}, {'type': 's', 'time': '2025-05-17T17:31:10.902Z'}, {'type': 's', 'time': '2025-05-17T17:31:13.216Z'}, {'type': 'l', 'time': '2025-05-17T17:31:14.641Z'}, {'type': 'l', 'time': '2025-05-17T17:31:19.256Z'}, {'type': 'l', 'time': '2025-05-17T17:31:23.259Z'}]",11,12,23,-1
67,67,7,B. campestris,1747503129216,2025-05-17T17:32:09.216Z,1747503249216,2025-05-17T17:34:09.216Z,"[{'type': 's', 'time': '2025-05-17T17:32:11.683Z'}, {'type': 's', 'time': '2025-05-17T17:32:14.563Z'}, {'type': 'l', 'time': '2025-05-17T17:32:21.786Z'}, {'type': 's', 'time': '2025-05-17T17:32:26.887Z'}, {'type': 'l', 'time': '2025-05-17T17:32:33.080Z'}, {'type': 's', 'time': '2025-05-17T17:32:36.802Z'}, {'type': 's', 'time': '2025-05-17T17:32:43.420Z'}, {'type': 'l', 'time': '2025-05-17T17:32:48.553Z'}, {'type': 'l', 'time': '2025-05-17T17:32:52.029Z'}, {'type': 'l', 'time': '2025-05-17T17:33:00.162Z'}, {'type': 's', 'time': '2025-05-17T17:33:04.185Z'}, {'type': 's', 'time': '2025-05-17T17:33:07.592Z'}, {'type': 's', 'time': '2025-05-17T17:33:10.685Z'}, {'type': 's', 'time': '2025-05-17T17:33:12.926Z'}, {'type': 'l', 'time': '2025-05-17T17:33:21.166Z'}, {'type': 's', 'time': '2025-05-17T17:33:28.138Z'}, {'type': 'l', 'time': '2025-05-17T17:33:32.927Z'}, {'type': 's', 'time': '2025-05-17T17:33:35.885Z'}, {'type': 's', 'time': '2025-05-17T17:33:41.335Z'}, {'type': 's', 'time': '2025-05-17T17:33:45.342Z'}, {'type': 'l', 'time': '2025-05-17T17:33:47.451Z'}, {'type': 'l', 'time': '2025-05-17T17:33:54.457Z'}, {'type': 's', 'time': '2025-05-17T17:33:56.959Z'}, {'type': 's', 'time': '2025-05-17T17:33:59.432Z'}, {'type': 'l', 'time': '2025-05-17T17:34:02.226Z'}, {'type': 's', 'time': '2025-05-17T17:34:04.792Z'}]",16,10,26,6
68,68,7,B. pratorum,1747503362439,2025-05-17T17:36:02.439Z,1747503482439,2025-05-17T17:38:02.439Z,"[{'type': 's', 'time': '2025-05-17T17:36:14.103Z'}, {'type': 's', 'time': '2025-05-17T17:36:17.970Z'}, {'type': 's', 'time': '2025-05-17T17:36:20.969Z'}, {'type': 's', 'time': '2025-05-17T17:36:25.552Z'}, {'type': 'l', 'time': '2025-05-17T17:36:31.577Z'}, {'type': 's', 'time': '2025-05-17T17:36:34.179Z'}, {'type': 's', 'time': '2025-05-17T17:36:37.775Z'}, {'type': 'l', 'time': '2025-05-17T17:36:41.776Z'}, {'type': 'l', 'time': '2025-05-17T17:36:49.219Z'}, {'type': 's', 'time': '2025-05-17T17:36:53.668Z'}, {'type': 'l', 'time': '2025-05-17T17:36:56.210Z'}, {'type': 'l', 'time': '2025-05-17T17:37:02.834Z'}, {'type': 'l', 'time': '2025-05-17T17:37:07.210Z'}, {'type': 's', 'time': '2025-05-17T17:37:10.409Z'}, {'type': 's', 'time': '2025-05-17T17:37:14.692Z'}, {'type': 'l', 'time': '2025-05-17T17:37:21.014Z'}, {'type': 's', 'time': '2025-05-17T17:37:25.400Z'}, {'type': 's', 'time': '2025-05-17T17:37:30.897Z'}, {'type': 's', 'time': '2025-05-17T17:37:32.958Z'}, {'type': 's', 'time': '2025-05-17T17:37:37.660Z'}, {'type': 'l', 'time': '2025-05-17T17:37:43.083Z'}, {'type': 'l', 'time': '2025-05-17T17:37:52.274Z'}]",13,9,22,4
69,69,7,B. lucorum,1747503531897,2025-05-17T17:38:51.897Z,1747503651897,2025-05-17T17:40:51.897Z,"[{'type': 's', 'time': '2025-05-17T17:38:53.722Z'}, {'type': 's', 'time': '2025-05-17T17:38:56.288Z'}, {'type': 'l', 'time': '2025-05-17T17:38:58.946Z'}, {'type': 'l', 'time': '2025-05-17T17:39:01.328Z'}, {'type': 's', 'time': '2025-05-17T17:39:03.154Z'}, {'type': 's', 'time': '2025-05-17T17:39:05.664Z'}, {'type': 's', 'time': '2025-05-17T17:39:08.420Z'}, {'type': 's', 'time': '2025-05-17T17:39:10.429Z'}, {'type': 's', 'time': '2025-05-17T17:39:12.492Z'}, {'type': 's', 'time': '2025-05-17T17:39:15.220Z'}, {'type': 's', 'time': '2025-05-17T17:39:18.555Z'}, {'type': 'l', 'time': '2025-05-17T17:39:23.353Z'}, {'type': 's', 'time': '2025-05-17T17:39:25.378Z'}, {'type': 's', 'time': '2025-05-17T17:39:27.249Z'}, {'type': 'l', 'time': '2025-05-17T17:39:29.551Z'}, {'type': 's', 'time': '2025-05-17T17:39:33.419Z'}, {'type': 's', 'time': '2025-05-17T17:39:36.202Z'}, {'type': 's', 'time': '2025-05-17T17:39:38.578Z'}, {'type': 'l', 'time': '2025-05-17T17:39:42.302Z'}, {'type': 'l', 'time': '2025-05-17T17:39:45.528Z'}, {'type': 's', 'time': '2025-05-17T17:39:47.899Z'}, {'type': 's', 'time': '2025-05-17T17:39:50.710Z'}, {'type': 's', 'time': '2025-05-17T17:39:54.568Z'}, {'type': 's', 'time': '2025-05-17T17:40:04.872Z'}, {'type': 's', 'time': '2025-05-17T17:40:09.992Z'}, {'type': 's', 'time': '2025-05-17T17:40:13.592Z'}, {'type': 's', 'time': '2025-05-17T17:40:17.795Z'}, {'type': 'l', 'time': '2025-05-17T17:40:29.015Z'}, {'type': 's', 'time': '2025-05-17T17:40:33.748Z'}, {'type': 's', 'time': '2025-05-17T17:40:35.833Z'}, {'type': 's', 'time': '2025-05-17T17:40:39.949Z'}, {'type': 's', 'time': '2025-05-17T17:40:42.917Z'}, {'type': 'l', 'time': '2025-05-17T17:40:47.082Z'}, {'type': 's', 'time': '2025-05-17T17:40:51.092Z'}]",26,8,34,18
